input1	input2	input3	label
computers	The	The octopus smiled.	The computers octopus smiled.
posted	on	When she finished, she hung the collage on the wall.	When she finished, she hung the collage on posted the wall.
single	giggled	He squirmed and giggled, feeling so spoiled and loved.	He squirmed and giggled single, feeling so spoiled and loved.
that	for	They waited and waited for the car to come.	They waited and waited for that the car to come.
deals	He	He found a shiny medal!	He deals found a shiny medal!
thought	They	They wanted to surf, but they couldn't.	They thought wanted to surf, but they couldn't.
food	to	She wanted to go there and smell them.	She wanted to food go there and smell them.
book	This	This time he was going with his mum and dad.	This book time he was going with his mum and dad.
property	there	In this town, there was an old house.	In this town, there property was an old house.
these	off	She hit the rock and fell off the bike.	She hit the rock and fell off these the bike.
sure	But	But he couldn't make it work.	But sure he couldn't make it work.
feel	bathing	She thinks bathing is boring and cold and wet.	She thinks bathing feel is boring and cold and wet.
add	outside	They hear their dad's voice outside the door.	They hear their dad's voice outside add the door.
pages	what	But it does not do what they want.	But it does not do what pages they want.
turn	counting	The Cow started counting.	The Cow started counting turn.
schools	you'll	I think you'll love it, Lily.	I think you'll schools love it, Lily.
sell	away	Suddenly the butterfly fluttered away.	Suddenly the butterfly fluttered away sell.
start	was	Everyone in the family was very excited.	Everyone in the family was start very excited.
natural	wonderful	When she opened it, she saw a wonderful treasure inside!	When she opened it, she saw a wonderful natural treasure inside!
during	He	He helped Lila get what she wanted.	He during helped Lila get what she wanted.
error	soup	He tasted the soup and it was delicious!	He tasted the soup error and it was delicious!
different	old	The old man smiled and gave her a big hug.	The old different man smiled and gave her a big hug.
categories	it	She finally caught it!	She finally caught it categories!
children	yard	You will have your own rooms and a big yard.	You will have your own rooms and a big yard children.
using	teamwork	They were excited and proud of their teamwork.	They were excited and proud of their teamwork using.
sign	put	He put on his hat and coat and ran outside.	He put sign on his hat and coat and ran outside.
adult	friends	They are good friends.	They are good friends adult.
speed	found	Inside the box, Lily found a beautiful dress.	Inside the box, Lily found speed a beautiful dress.
five	fun	They have fun.	They have fun five.
bit	wanted	He wanted to help out.	He wanted bit to help out.
then	she	She wishes she did not have that idea.	She wishes she then did not have that idea.
financial	know	I know you love your castle.	I know financial you love your castle.
magazine	She	She hoped her dad did not see her.	She magazine hoped her dad did not see her.
magazine	park	It finds another child in the park.	It finds another child in the park magazine.
format	smiled	She smiled when she saw him.	She smiled format when she saw him.
want	named	Once there was a little boy named Robby.	Once there was a little boy named want Robby.
san	Once	Once upon a time, there was a girl.	Once san upon a time, there was a girl.
could	mom	She went to tell the news to her mom.	She went to tell the news to her mom could.
who	very	They were very happy with their work.	They were very who happy with their work.
journal	Bertha	Bertha was sad and cried.	Bertha journal was sad and cried.
area	be	You should not be here.	You should not be area here.
get	gone	But when she came back, the horse was gone!	But when she came back, the horse was gone get!
condition	red	She saw a big red spot on his hand.	She saw a big red condition spot on his hand.
january	worked	Every day they worked very hard in the fields.	Every day they worked january very hard in the fields.
golf	was	His name was Quick.	His name was golf Quick.
loss	of	She was proud of Lily for being smart and polite.	She was proud of loss Lily for being smart and polite.
business	sunflower	It was called a sunflower.	It was called a sunflower business.
questions	small	So they looked inside the small theater.	So they looked inside the small questions theater.
board	others	With the help of others, anything is possible!	With the help of others board, anything is possible!
centre	Lily's	It is Lily's mom.	It is Lily's centre mom.
said	She	She went to the park with her mom and dad.	She said went to the park with her mom and dad.
player	learned	Lily learned to be careful around sharp objects like needles.	Lily learned player to be careful around sharp objects like needles.
music	felt	Anna felt like crying.	Anna felt music like crying.
library	lion	Once upon a time, there was a furry lion.	Once upon a time, there was a furry lion library.
states	Lily	Lily and Ben were curious.	Lily states and Ben were curious.
top	her	He hugged her.	He hugged her top.
gifts	still	Maybe it is still on the road.	Maybe it is still gifts on the road.
means	to	Tom did not like to play or run.	Tom did not like to means play or run.
feb	carrots	Benny had a big opinion about carrots, he loved them!	Benny had a big opinion about carrots feb, he loved them!
education	He	He runs away with Lily.	He education runs away with Lily.
log	Ben	Ben does not listen.	Ben log does not listen.
view	Sophie's	But then, Sophie's dad came over to her.	But then, Sophie's view dad came over to her.
his	about	This is one of their favorite stories about Rudolph!	This is one of their favorite stories about his Rudolph!
black	girl	The little girl smiled.	The little girl black smiled.
shipping	skin	She loved the feeling of the rain on her skin.	She loved the feeling of the rain on her skin shipping.
live	listen	Tim learned to listen next time.	Tim learned to listen live next time.
powered	kitchen	She went to the kitchen and saw two cereals.	She went to the kitchen powered and saw two cereals.
kingdom	juice	Timmy loved to drink juice.	Timmy loved to drink juice kingdom.
men	nodded	The face smiled and nodded its head.	The face smiled and nodded men its head.
downloads	in	Tom and Lily are playing in the park.	Tom and Lily are playing in downloads the park.
problems	His	His dad laughed.	His problems dad laughed.
enough	ran	She fell when she ran from the dog.	She fell when she ran enough from the dog.
four	they	Together, they wove a beautiful rainbow pattern into the sky.	Together, they four wove a beautiful rainbow pattern into the sky.
group	two	One day, the two friends went to the opera.	One day, the two group friends went to the opera.
drug	were	Sparkles were shooting out from the town and everyone cheered.	Sparkles were drug shooting out from the town and everyone cheered.
design	loved	The prince was very kind and loved to help others.	The prince was very kind and loved design to help others.
schools	Lily	Anna and Ben and Lily listen to their mom.	Anna and Ben and Lily schools listen to their mom.
within	discovering	Mary took many steps forward, discovering new places and things.	Mary took many steps forward, discovering within new places and things.
tools	and	Ben felt sad and angry.	Ben felt sad and tools angry.
other	remembered	Jack always remembered.	Jack always remembered other.
third	proud	Finny was so proud of his find.	Finny was so proud third of his find.
every	the	They wanted to get out of the cave.	They wanted to get out of the every cave.
store	friends	Tim and Sam were friends.	Tim and Sam were friends store.
being	liked	He liked to be a knight and defend it.	He liked being to be a knight and defend it.
million	tried	He ran after Lily and tried to grab the net.	He ran after Lily and tried million to grab the net.
out	They	They were always encouraging each other.	They out were always encouraging each other.
community	hear	They hear a noise.	They hear community a noise.
standard	a	It is a dress.	It is a standard dress.
feedback	Her	Her grandma said, â€œItâ€™s my birthday party!	Her feedback grandma said, â €œItâ €™ s my birthday party!
love	behave	Jack felt sad because he knew he didn't behave well.	Jack felt sad because he knew he didn't behave love well.
did	Once	Once upon a time there was a lucky figure.	Once did upon a time there was a lucky figure.
usually	them	She showed them their room.	She showed them usually their room.
words	their	The girls were so proud of their work.	The girls were so proud of their words work.
comments	look	â€œLetâ€™s go and look at it,â€ said Mandy.	â €œLetâ €™ s go and look comments at it, â €said Mandy.
cell	looked	He shivered and quickly looked back.	He shivered and quickly looked cell back.
already	and	Jennifer calmed down and smiled.	Jennifer calmed down and already smiled.
schools	barber	He was a very bad barber.	He was a very bad barber schools.
europe	not	They do not want any gum.	They do not europe want any gum.
green	their	They want to have their own way.	They want to have their green own way.
red	Alex	Alex had never seen him from before.	Alex red had never seen him from before.
following	something	Suddenly, he noticed something shining in a nearby bush.	Suddenly, he noticed something following shining in a nearby bush.
rss	was	Once upon a time, there was a boy called John.	Once upon a time, there was rss a boy called John.
try	spear	He threw the spear at the rabbit and hit it.	He threw the spear try at the rabbit and hit it.
loss	a	They find a lot of junk in the yard.	They find a loss lot of junk in the yard.
gift	a	Finally, they found it in a park.	Finally, they found it in a gift park.
access	nodded	Jane nodded and smiled.	Jane nodded access and smiled.
minutes	Sara	Sara and Tom say they are sorry.	Sara minutes and Tom say they are sorry.
average	duck	He thanks the duck and takes his ball.	He thanks the duck average and takes his ball.
without	off	She quickly took off the hat and ran inside.	She quickly took off without the hat and ran inside.
condition	loved	She loved to explore and play outside.	She loved condition to explore and play outside.
not	heard	Lily's mom heard her singing and came into the room.	Lily's mom heard not her singing and came into the room.
downloads	the	He held the magnet near a metal spoon.	He held the downloads magnet near a metal spoon.
more	starts	The balloon starts to rise in the air.	The balloon starts more to rise in the air.
users	He	He thought to himself.	He users thought to himself.
message	One	One day, Tom was at the park with his Mom.	One message day, Tom was at the park with his Mom.
never	licks	He licks his mouth.	He licks never his mouth.
let	grateful	You should be grateful for what you have.	You should be grateful let for what you have.
popular	to	Lily was sad and started to cry.	Lily was sad and started to popular cry.
they	his	But he also likes to play with his stand.	But he also likes to play with his they stand.
like	scared	He was scared and cold.	He was scared like and cold.
terms	did	They did not see the big wave coming.	They did terms not see the big wave coming.
side	sad	Anna is sad.	Anna is sad side.
directory	but	She thought it was nice, but she was hungry.	She thought it was nice, but directory she was hungry.
yet	box	It seemed to be a glass box.	It seemed to be a glass box yet.
registered	saw	They saw the pile of leaves gone.	They saw registered the pile of leaves gone.
meet	took	He took a big bite and was very satisfied.	He took meet a big bite and was very satisfied.
best	a	She was very excited as she had a special surprise.	She was very excited as she had a best special surprise.
years	and	He was big and round.	He was big and years round.
council	very	She loved horses very much.	She loved horses very council much.
health	nodded	Sammy cautiously nodded.	Sammy cautiously nodded health.
shop	giggled	Lisa giggled and took out her camera.	Lisa giggled shop and took out her camera.
minutes	grumpy	Lazy makes you sad and grumpy.	Lazy makes you sad and grumpy minutes.
yellow	She	She scolded Ben and told him to go away.	She yellow scolded Ben and told him to go away.
side	slide	They get to the slide first.	They get to the slide side first.
listings	Tom	Tim and Tom look at each other.	Tim and Tom listings look at each other.
aug	laughed	The lady told him stories and they laughed together.	The lady told him stories and they laughed aug together.
current	had	Lily and Ben had lots of fun drawing together.	Lily and Ben had current lots of fun drawing together.
from	noises	They were angry and making loud noises.	They were angry and making loud noises from.
interest	smiled	They looked at their work and smiled.	They looked at their work and smiled interest.
apr	magazine	The beautiful bird felt sad that her magazine was gone.	The beautiful bird felt sad that her magazine apr was gone.
like	in	Lily and Spot played in the grass all day long.	Lily and Spot played in like the grass all day long.
welcome	their	And they both enjoyed their soup.	And they both enjoyed their welcome soup.
here	in	She saw a big, furry animal in front of her.	She saw a big, furry animal in here front of her.
until	too	I love you too.	I love you too until.
arts	the	She sees the note.	She sees the arts note.
building	very	It is very cute.	It is very building cute.
effective	They	They liked to play together in the park.	They effective liked to play together in the park.
region	and	They pull and push.	They pull and region push.
august	woke	Milo woke up, and saw Lily crying.	Milo woke august up, and saw Lily crying.
players	She	She wanted to succeed.	She players wanted to succeed.
availability	everywhere	Once upon a time, everywhere was dark.	Once upon a time, everywhere availability was dark.
because	yelling	Why are you yelling and fighting?	Why are you yelling because and fighting?
purchase	Toby	Toby couldn't wait!	Toby purchase couldn't wait!
and	and	He tried hard, and finally got the rhythm right.	He tried hard, and and finally got the rhythm right.
try	roared	He was deaf and roared at her.	He was deaf and roared try at her.
internet	You	You are very naughty!	You internet are very naughty!
park	Bob	Bob was happy to help.	Bob park was happy to help.
education	named	Once there was a little girl named Bella.	Once there was a little girl named education Bella.
next	of	The wise old man was so proud of his masterpiece.	The wise old man was so proud of next his masterpiece.
public	it	She picked up her ball and threw it to Spot.	She picked up her ball and threw it public to Spot.
via	make	So, he decided to make a costume.	So, he decided to make via a costume.
family	and	Her mom smiled at her and said, â€œSee?	Her mom smiled at her and family said, â €œSee?
are	to	They wanted to climb it.	They wanted to are climb it.
weight	a	They set up a tent in the woods.	They set up a weight tent in the woods.
adult	mom	She did not want to make her mom sad.	She did not want to make her mom adult sad.
then	so	They were so beautiful.	They were so then beautiful.
includes	liked	They liked to play with rocks and pages.	They liked includes to play with rocks and pages.
orders	is	That is very bad!	That is orders very bad!
state	day	One day, Tom has a gift for Anna.	One day state, Tom has a gift for Anna.
future	out	She was so happy and yelled out for joy!	She was so happy and yelled out future for joy!
anything	Inside	Inside, they found some candy and a funny toy!	Inside anything, they found some candy and a funny toy!
designed	joke	She ran over to him and told him another joke.	She ran over to him and told him another joke designed.
feedback	his	The little boy nodded and watched as his mom entered.	The little boy nodded and watched as his feedback mom entered.
girl	the	Suddenly, the fox heard a deep voice.	Suddenly, the girl fox heard a deep voice.
name	but	They worked hard, but things weren't going very well.	They worked hard, but name things weren't going very well.
easy	outside	Mia liked to play outside in the sun.	Mia liked to play outside easy in the sun.
rate	new	She learned something new and had fun.	She learned something new rate and had fun.
own	are	You are good at marking.	You are own good at marking.
systems	liked	John liked seeing how friendly the church was.	John liked systems seeing how friendly the church was.
printer	wanted	It wanted to take their ball.	It wanted printer to take their ball.
free	butterfly	The butterfly flew away but Jimmy kept staring.	The butterfly free flew away but Jimmy kept staring.
bad	Finally	She stirred and stirred until Finally, something happened.	She stirred and stirred until Finally bad, something happened.
air	wanted	Tom wanted to play with his car on the floor.	Tom wanted air to play with his car on the floor.
tax	shell	The little girl was excited to have her special shell.	The little girl was excited to have her special shell tax.
does	The	The man is angry.	The does man is angry.
continue	he	Max tried to pull himself free, but he couldn't.	Max tried to pull himself free, but he continue couldn't.
love	Lucy	Lucy was very sad and cried.	Lucy love was very sad and cried.
your	It	It was weird and shiny.	It your was weird and shiny.
memory	The	The cat was very sad.	The memory cat was very sad.
fax	her	Lily smiled and bounced on her ball.	Lily smiled and bounced on her fax ball.
media	did	He did not want to be friends with Jill anymore.	He did media not want to be friends with Jill anymore.
value	hand	He came out of his doghouse and licked her hand.	He came out of his doghouse and licked her hand value.
day	proud	Spot and Whiskers smiled, proud of their hard work.	Spot and Whiskers smiled, proud day of their hard work.
its	enjoyed	She enjoyed playing by the sea and watching the waves.	She enjoyed its playing by the sea and watching the waves.
town	there	He turned and saw a little girl standing there.	He turned and saw a little girl standing there town.
insurance	Snow	Tom's mom gave Snow some fish to eat.	Tom's mom gave Snow insurance some fish to eat.
download	He	He said he wanted to share his joy with someone.	He download said he wanted to share his joy with someone.
edit	his	John slowly turned his head and saw a large bird.	John slowly turned his edit head and saw a large bird.
did	and	She takes a wet cloth and wipes their faces.	She takes a wet cloth and did wipes their faces.
employment	friend	He looked at his friend Lily.	He looked at his friend employment Lily.
among	happy	She is happy.	She is happy among.
server	anymore	She wasn't worried anymore.	She wasn't worried anymore server.
course	of	But some of her friends were competitive too.	But some of course her friends were competitive too.
monday	and	She claps her hands and jumps up and down.	She claps her hands and monday jumps up and monday down.
close	with	We can decorate it with the flowers.	We can decorate it with close the flowers.
london	She	She had a pretty blouse that she liked to wear.	She london had a pretty blouse that she liked to wear.
new	was	But now, everything was gone and Timmy was sad.	But now, everything was new gone and Timmy was new sad.
professional	snowballs	They make snowballs and snowmen and snow forts.	They make snowballs professional and snowmen and snow forts.
members	broke	The dinosaur broke in half.	The dinosaur broke members in half.
required	to	He did not want to lose his wool.	He did not want to required lose his wool.
sale	her	So, Lily and her friends went up to the roof.	So, Lily and her sale friends went up to the roof.
still	and	She screamed and cried.	She screamed and still cried.
works	table	She carried the mug back to the table.	She carried the mug back to the table works.
share	had	Her brother had already passed away.	Her brother had share already passed away.
could	They	They each picked one.	They could each picked one.
jobs	by	He started by gathering shiny, thick rail to make it.	He started by jobs gathering shiny, thick rail to make it.
started	sitting	He saw a bench where Lila's mom was sitting.	He saw a bench where Lila's mom was sitting started.
money	diamond	The group decided to try and get the diamond back.	The group decided to try and get the diamond money back.
office	He	He made a big mess.	He office made a big mess.
cart	didn't	But Lily didn't care.	But Lily didn't cart care.
address	moving	Inside the school, Lucy saw a big moving file.	Inside the school, Lucy saw a big moving address file.
still	stirred	She stirred the soup.	She stirred still the soup.
oil	watered	Mommy watered the plants.	Mommy watered oil the plants.
forum	his	They hope the owl will like his cake too.	They hope the owl will like his forum cake too.
release	friend	Bow was happy he could help his new friend.	Bow was happy he could help his new friend release.
month	day	One day, she saw a pony in the park.	One day month, she saw a pony in the park.
gay	them	They asked him if he wanted to play with them.	They asked him if he wanted to play with them gay.
entertainment	the	The man helps them get in the basket.	The man helps them get in the entertainment basket.
india	loved	She loved to visit her grandma's house.	She loved india to visit her grandma's house.
equipment	a	It makes a loud noise.	It makes a equipment loud noise.
site	every	She loved to read books every day.	She loved to read books every site day.
database	blew	The wind blew harder.	The wind blew database harder.
problem	laugh	They laugh and giggle.	They laugh problem and giggle.
not	stay	She wanted to stay forever and admire the lab.	She wanted to stay not forever and admire the lab.
before	confusion	The friends looked at each other in confusion.	The friends looked at each other in confusion before.
receive	the	He walked to the armchair and peeked behind it.	He walked to the receive armchair and peeked behind it.
radio	She	She sat down on the grass and closed her eyes.	She radio sat down on the grass and closed her eyes.
called	He	He wanted to sleep in his bed.	He called wanted to sleep in his bed.
around	felt	Lily felt dizzy and scared.	Lily felt around dizzy and scared.
minutes	and	The tiger listened and left.	The tiger listened and minutes left.
building	the	They had shrunk when they went through the hole.	They had shrunk when they went through the building hole.
fax	a	It was a welcome sign.	It was a fax welcome sign.
currently	Suddenly	Suddenly, a big, scary creature appeared!	Suddenly currently, a big, scary creature appeared!
related	again	John tried again.	John tried again related.
join	the	She accidentally spilled it on the carpet.	She accidentally spilled it on the join carpet.
ago	They	They nod and hug.	They ago nod and hug.
growth	But	But it was too late.	But growth it was too late.
each	ran	Sarah ran up the hill as fast as she could.	Sarah ran each up the hill as fast as she could.
sun	picked	He saw a rock nearby and picked it up.	He saw a rock nearby and picked sun it up.
engine	girl	The girl smiled and waved goodbye.	The girl engine smiled and waved goodbye.
line	They	They packed their bags and went on a camping vacation.	They line packed their bags and went on a camping vacation.
information	and	She smiled and hugged him tight.	She smiled and information hugged him tight.
france	sad	She felt sad and sorry.	She felt sad france and sorry.
engine	€	The mouse asked him, â€œWhat do you want?	The mouse asked him, â €engine œWhat do you want?
kids	thought	She didn't like lectures and thought they were boring.	She didn't like lectures and thought kids they were boring.
having	and	They thought they were lucky and smart.	They thought they were lucky and having smart.
records	looks	Ben thinks it looks fun.	Ben thinks it looks records fun.
once	play	She did not want to play with Tom anymore.	She did not want to play once with Tom anymore.
community	But	But then, something bad happens.	But community then, something bad happens.
sites	better	He knew it was better to be kind.	He knew it was better sites to be kind.
pro	she	One day, she met a little boy named Jack.	One day, she pro met a little boy named Jack.
box	worried	Mom is worried.	Mom is worried box.
town	the	I want the fish.	I want the town fish.
into	to	They like to play in the park.	They like to into play in the park.
edition	his	Timmy asked his mommy what was in the mail.	Timmy asked his edition mommy what was in the mail.
among	loved	Tim loved to play outside with his toys.	Tim loved among to play outside with his toys.
kids	lost	Max was very troubled because he lost his bone.	Max was very troubled because he lost kids his bone.
david	Timmy	Timmy spread paint all over his paper.	Timmy david spread paint all over his paper.
gifts	picks	Sara picks a card.	Sara picks gifts a card.
percent	it	But it was too hard.	But it percent was too hard.
did	after	Everyone was happy and they all lived happily ever after.	Everyone was happy and they all lived happily ever after did.
gay	her	She was very small and her wings were green.	She was very small and her gay wings were green.
part	the	They take their books and run back to the swings.	They take their books and run back to the part swings.
children	this	How could it get out of this?	How could it get out of this children?
gay	the	Mom said yes, and gave her the needle.	Mom said yes, and gave her the gay needle.
views	tightly	It was stuck so tightly that it couldn't move.	It was stuck so tightly views that it couldn't move.
notice	was	Poppy was happy because she had learned something new today.	Poppy was notice happy because she had learned something new today.
lake	a	He looked around and saw a crystal!	He looked around and saw a lake crystal!
government	him	The cat caught the little bird and ate him up.	The cat caught the little bird and ate him government up.
name	was	Tim was not hungry anymore.	Tim was name not hungry anymore.
days	was	Once there was a skeleton.	Once there was days a skeleton.
deals	this	Everyone laughed at this, but the king was not amused.	Everyone laughed at this deals, but the king was not amused.
games	They	They do not share the berries.	They games do not share the berries.
bank	gold	He reached down and found a gold hook!	He reached down and found a gold bank hook!
costs	visit	One day, Timmy's friend came to visit him.	One day, Timmy's friend came to visit costs him.
time	exams	Tom did not like exams.	Tom did not like exams time.
categories	worked	They worked together and built the fence.	They worked categories together and built the fence.
computers	balloon	He gives them the balloon.	He gives them the balloon computers.
figure	flowers	It was white and blue and had flowers on it.	It was white and blue and had flowers figure on it.
stories	vroom	Vroom, vroom, beep, beep!	Vroom, vroom stories, beep, beep!
less	noises	There were many people and noises.	There were many people and noises less.
team	modern	He liked modern things.	He liked modern team things.
downloads	for	They say they are ready for the baby.	They say they are ready for downloads the baby.
includes	and	Spot barked and wagged his tail.	Spot barked and includes wagged his tail.
content	It	It broke into many pieces.	It content broke into many pieces.
player	a	Bob lived in a wide forest.	Bob lived in a player wide forest.
form	a	The cat was playing with a ball.	The cat was playing with a form ball.
still	home	Then she knew the way home.	Then she knew the way home still.
drug	bow	She gave him a yellow hat with a bow.	She gave him a yellow hat with a bow drug.
clear	he	He tried and tried, but he just couldn't tie them.	He tried and tried, but he clear just couldn't tie them.
knowledge	and	She was very brave and put her toe in first!	She was very brave and knowledge put her toe in first!
history	He	He was scared that he had hurt his best friend.	He history was scared that he had hurt his best friend.
customer	and	They liked to build towers and knock them down.	They liked to build towers and customer knock them down.
become	and	They see many pictures and words on the screen.	They see many pictures and become words on the screen.
growth	sad	He was very sad.	He was very sad growth.
series	to	He liked to try new things.	He liked to series try new things.
sale	and	Inch nodded and started to help.	Inch nodded and sale started to help.
first	and	One day, Tim and Sam had a plan.	One day, Tim and first Sam had a plan.
large	the	Sam and Mia nodded and followed the man.	Sam and Mia nodded and followed the large man.
general	Tom	Tom was sad.	Tom general was sad.
making	They	They loved their new novel.	They making loved their new novel.
poker	work	He grabbed the rake and started to work.	He grabbed the rake and started to work poker.
provide	storm	Lily was scared of the storm.	Lily was scared of the storm provide.
off	tightly	Then Daisy and Mama hugged tightly.	Then Daisy and Mama hugged tightly off.
adult	took	They got the red ball and took it home.	They got the red ball and took adult it home.
european	three	Jimmy was a generous three year old.	Jimmy was a generous three european year old.
federal	held	He held his car tightly in his hand.	He held federal his car tightly in his hand.
which	away	The plane flew away and the people said goodbye.	The plane flew away which and the people said goodbye.
reserved	each	Her parents hugged each other and her brother giggled.	Her parents hugged each reserved other and her brother giggled.
she	things	Every morning, Lola woke up impatient to learn more things.	Every morning, Lola woke up impatient to learn more things she.
photo	fun	They forgot about the mosquito and had fun.	They forgot about the mosquito and had fun photo.
engine	ball	They see the ball.	They see the ball engine.
terms	started	The little girl was amazed and started to laugh.	The little girl was amazed and started terms to laugh.
contents	kind	He peeked inside and saw a kind teacher inside.	He peeked inside and saw a kind contents teacher inside.
password	her	Tom tickled her under her chin and she clucked happily.	Tom tickled her password under her password chin and she clucked happily.
options	not	Lily was very careful not to touch it.	Lily was very careful not options to touch it.
technology	Lily	Lily liked to bake cakes and cookies with Mom.	Lily technology liked to bake cakes and cookies with Mom.
call	hand	Mummy took her hand and led her to the car.	Mummy took her hand call and led her to the car.
both	lunch	She ate all of her lunch, every last bite.	She ate all of her lunch both, every last bite.
update	the	They do not want to leave the pool.	They do not want to leave the update pool.
credit	more	He wanted to be the best more than anyone else.	He wanted to be the best more credit than anyone else.
quote	is	Ben is Sara's brother.	Ben is quote Sara's brother.
parts	nest	He worked hard and made the nest big and cozy.	He worked hard and made the nest parts big and cozy.
made	upset	Milly was upset.	Milly was upset made.
committee	began	They began to play together in the jungle.	They began committee to play together in the jungle.
over	But	But, he was already thinking about his next creative vacation.	But over, he was already thinking about his next creative vacation.
golf	pushed	The waves pushed the boat away from the shore.	The waves pushed golf the boat away from the shore.
class	happy	They had fun and they were happy.	They had fun and they were happy class.
several	she	She said she was so happy to see them.	She said she several was so happy to see them.
edit	move	The bus starts to move.	The bus starts to move edit.
association	her	She was surprised and showed her mom.	She was surprised and showed her association mom.
exchange	saw	When they began to walk around, she saw fake jewels.	When they began to walk around, she saw exchange fake jewels.
products	was	She was trying to protect you.	She was products trying to protect you.
bank	and	So they hopped into the car and drove off.	So they hopped into the car and bank drove off.
remember	down	They sat down together and opened the dictionary.	They sat down remember together and opened the dictionary.
collection	it	She decided to steal it when Lily wasn't looking.	She decided to steal it collection when Lily wasn't looking.
pictures	sat	He sat outside his hut and smiled at the sun.	He sat pictures outside his hut and smiled at the sun.
living	Sarah	Sarah thought about what the voice said.	Sarah living thought about what the voice said.
old	playing	They were laughing and playing, and she smiled to herself.	They were laughing and playing old, and she smiled to herself.
program	Ben	Ben screams and cries.	Ben program screams and cries.
jul	did	He did not want his car to grow.	He did jul not want his car to grow.
trade	the	But their favorite thing was to play with the pumpkins.	But their favorite thing was to play with the trade pumpkins.
digital	feel	Tim wanted to help Sue feel better.	Tim wanted to help Sue feel digital better.
top	that	Jack could tell that the bandage was very flexible.	Jack could tell that top the bandage was very flexible.
reviews	the	She loved to play in the park with her friends.	She loved to play in the reviews park with her friends.
added	of	The boat stopped in front of it.	The boat stopped in front of added it.
card	a	You are a mean animal!	You are a card mean animal!
hardware	sad	Ben was sad.	Ben was sad hardware.
forums	is	It is taller than Ben.	It is forums taller than Ben.
michael	was	Daisy was very busy everyday.	Daisy was michael very busy everyday.
around	looked	So the little boy looked up at the roof.	So the little boy looked around up at the roof.
unit	does	It does not fit.	It does unit not fit.
forum	purple	She had a toy chest that was big and purple.	She had a toy chest that was big and purple forum.
sex	upon	Once upon a time, there was a lively dancer.	Once upon sex a time, there was a lively dancer.
upon	so	Who are you?â€ Bob was so surprised!	Who are you? â €Bob was so upon surprised!
advertise	bright	The yellow and orange sky was so bright and cute.	The yellow and orange sky was so bright advertise and cute.
minutes	he	He sang even when he was scared.	He sang even when he minutes was scared.
annual	Lila	Lila reached the top of the slide and looked down.	Lila annual reached the top of the slide and looked down.
day	They	They look at the dog.	They day look at the dog.
brand	But	But Ben likes rain.	But brand Ben likes rain.
quality	wet	It is dark and wet.	It is dark and wet quality.
advertise	events	He liked to test events and see how they went.	He liked to test events advertise and see how they went.
final	but	They wanted to try it, but there was a problem.	They wanted to try it, but final there was a problem.
above	is	Tom is scared.	Tom is above scared.
america	She	She liked to play with Spot.	She america liked to play with Spot.
poker	for	He also felt sorry for the cat.	He also felt sorry for poker the cat.
summary	was	Once upon a time there was a big girl.	Once upon a time there was summary a big girl.
london	the	As the days went by, the seed started to grow.	As the london days went by, the london seed started to grow.
order	not	Mommy is not here.	Mommy is not order here.
cases	rusty	It is broken and rusty.	It is broken and rusty cases.
year	hugged	They hugged each other, and walked back to their ship.	They hugged year each other, and walked back to their ship.
king	What	What are you?	What king are you?
needed	The	The little seeds would grow into new trees.	The needed little seeds would grow into new trees.
center	liked	Anna liked to learn new things.	Anna liked center to learn new things.
views	They	They have a good day.	They views have a good day.
natural	His	His mom was amazed by the colorful tuna.	His natural mom was amazed by the colorful tuna.
information	day	He loved to play with his toys all day long.	He loved to play with his toys all day information long.
plan	weren't	She always asked permission before taking things that weren't hers.	She always asked permission before taking things that weren't plan hers.
credit	trusted	She trusted her mom.	She trusted credit her mom.
tell	share	He does not want to share.	He does not want to share tell.
board	with	It was glowing with many colors.	It was glowing with board many colors.
want	and	They have many colors and sounds.	They have many colors and want sounds.
research	the	Out of the deep sea came a skeleton!	Out of the research deep sea came a skeleton!
tickets	and	The dove and girl stared at each other.	The dove and tickets girl stared at each other.
means	worker	He is a worker.	He is a worker means.
jul	to	She wanted to escape!	She wanted to jul escape!
times	until	He chewed and chewed until it was all gone.	He chewed and chewed until times it was all gone.
back	strong	Dad pored the hot, strong coffee into two cups.	Dad pored the hot, strong back coffee into two cups.
problems	It	It sees Tom and Jen.	It problems sees Tom and Jen.
australia	The	The bump was bad.	The australia bump was bad.
past	is	The big boy is mad.	The big boy is past mad.
even	felt	Lily felt proud of herself for doing the right thing.	Lily felt even proud of herself for doing the right thing.
sep	Ben	Lily and Ben learned their lesson.	Lily and Ben sep learned their lesson.
nature	could	They could not find the stairs.	They could nature not find the stairs.
beach	us	Can you hear us?	Can you hear us beach?
details	Tim	Tim went back to his house, tired but happy.	Tim details went back to his house, tired but happy.
life	John	John sadly returned to his house, all alone.	John life sadly returned to his house, all alone.
share	liked	They liked to play in the park.	They liked share to play in the park.
about	They	They had made a big mess.	They about had made a big mess.
while	She	She zipped up her coat and left it alone.	She while zipped up her coat and left it alone.
comment	and	Mom and dad are happy.	Mom and comment dad are happy.
keep	loved	She loved to play games with her friends.	She loved keep to play games with her friends.
golf	got	The girl got on the train and made a request.	The girl got golf on the train and made a request.
online	He	He made funny noises.	He online made funny noises.
type	and	The boy was very frustrated and anxious.	The boy was very frustrated and type anxious.
title	bit	The dog got scared and bit Timmy.	The dog got scared and bit title Timmy.
via	gone	They are gone.	They are gone via.
him	said	Lily said she wanted to touch the curtains.	Lily said him she wanted to touch the curtains.
group	happy	Lily was so happy and amazed by the magic.	Lily was so happy group and amazed by the magic.
fire	were	You were not gentle.	You were fire not gentle.
out	curious	They are happy and curious.	They are happy and curious out.
net	to	He goes to the slide and sees the big box.	He goes to net the slide and sees the big box.
plans	things	They put a lot of things in different bags.	They put a lot of things plans in different bags.
air	mommy	One day, Billy 's mommy took him to the park.	One day, Billy's mommy air took him to the park.
process	neighing	Suddenly, he heard a neighing sound.	Suddenly, he heard a neighing process sound.
school	up	The bird agreed to help Sammy clean up his home.	The bird agreed to help Sammy clean up school his home.
listed	and	It was a fun and delicious day!	It was a fun and listed delicious day!
energy	are	You are the best.	You are energy the best.
economic	covers	She covers her nose with her hand.	She covers economic her nose with her hand.
however	Mandy	Tom and Mandy were so scared!	Tom and Mandy however were so scared!
press	are	They are happy.	They are press happy.
work	One	One night, Lily and Sarah were getting ready for bed.	One work night, Lily and Sarah were getting ready for bed.
now	That	That is a nice book.	That now is a nice book.
held	the	The elephant nods and pushes the ball to them.	The elephant nods and pushes the held ball to them.
june	He	He loved his orange ball.	He june loved his orange ball.
brand	could	You could have hurt yourself.	You could brand have hurt yourself.
problem	from	He wanted to run away from home.	He wanted to run away from problem home.
now	bowl	Soon the bowl was gone.	Soon the bowl now was gone.
against	both	They both got angry and started to cry.	They both against got angry and started to cry.
systems	to	You have to be patient and wait for your birthday.	You have to systems be patient and wait for your birthday.
location	Amy	Amy had a wild dream.	Amy location had a wild dream.
tips	danced	The puppet waved its tiny arms and danced.	The puppet waved its tiny arms and danced tips.
security	hill	One day, they see a big hill.	One day, they see a big hill security.
word	very	John's sister was very hairy.	John's sister was very word hairy.
join	sleeping	It was sleeping on a mat.	It was sleeping join on a mat.
japan	nodded	Ben smiled and nodded.	Ben smiled and nodded japan.
state	That	That is my diary!	That state is my diary!
has	was	She was very scared and didn't know what to do.	She was has very scared and didn't know what to do.
help	with	They make a new palace with the leaves and branches.	They make a new palace with help the leaves and branches.
things	the	She loved to play outside in the park.	She loved to play outside in the things park.
screen	and	The puppy touched her hand and she felt much better.	The puppy touched her hand and screen she felt much better.
golf	He	He was so excited!	He golf was so excited!
figure	She	She felt scared and sorry.	She figure felt scared and sorry.
articles	sings	Lily sings loud and fast.	Lily sings articles loud and fast.
here	best	It was her best friend, the old black lab.	It was her best here friend, the old black lab.
april	Max	One day, Max went for a walk and got lost.	One day, Max april went for a walk and got lost.
among	Anna	Anna said, holding her dolls.	Anna among said, holding her dolls.
texas	fast	They turn on the fan and make it spin fast.	They turn on the fan and make it spin fast texas.
videos	Lily	Lily smiled too.	Lily videos smiled too.
press	go	The children had to go home.	The children had to go press home.
under	he	He said he did not need her.	He said he under did not need her.
auto	and	Lila and Ben like to play with blocks.	Lila and auto Ben like to play with blocks.
down	try	But try as they might, they couldn't catch it.	But try down as they might, they couldn't catch it.
staff	summer	Once upon a time there was a hot summer.	Once upon a time there was a hot summer staff.
size	to	Jo was three years old and she loved to explore.	Jo was three years old and she loved to size explore.
car	good	I thought it was good cheese.	I thought it was good car cheese.
development	Suddenly	Suddenly, she spotted a pile of dust on the ground.	Suddenly development, she spotted a pile of dust on the ground.
july	Tom	Lily and Tom were very happy.	Lily and Tom july were very happy.
agency	a	It is a dog.	It is a agency dog.
double	some	They saw some kids playing on the swings and slides.	They saw some double kids playing on the swings and slides.
three	felt	Mom felt sorry for them.	Mom felt three sorry for them.
group	Her	Her Mama rushed over to see what happened.	Her group Mama rushed over to see what happened.
build	proud	Little Tommy was very proud.	Little Tommy was very proud build.
tickets	She	She says the cake is delicate.	She tickets says the cake is delicate.
through	angel	It was an angel.	It was an angel through.
pay	his	Spot barks and wags his tail.	Spot barks and wags his pay tail.
while	spinning	He felt so dizzy, like he was spinning around.	He felt so dizzy, like he was spinning while around.
package	sweet	She loved to eat sweet things, especially sugar.	She loved to eat sweet package things, especially sugar.
author	her	Lily cheered and lifted her car in the air.	Lily cheered and lifted her author car in the air.
articles	girl	Once there was a little girl named Lucy.	Once there was a little girl articles named Lucy.
solutions	closed	She held Lily and Ben's hands and closed her eyes.	She held Lily and Ben's hands and closed solutions her eyes.
against	salt	We need some salt.	We need some salt against.
code	piece	He also breaks a small piece and tastes it.	He also breaks a small piece code and tastes it.
rating	into	He broke it into pieces and gave some to Lily.	He broke it into rating pieces and gave some to Lily.
baby	something	But then something magical happened!	But then something baby magical happened!
specific	is	Ben is scared.	Ben is specific scared.
well	Tom	Lily and Tom hugged him back.	Lily and Tom well hugged him back.
non	old	She was 3 years old and really loved pizza.	She was 3 years old non and really loved pizza.
county	if	They asked their mom if they could open it.	They asked their mom if county they could open it.
which	He	He stopped running and suddenly he had a brilliant idea.	He which stopped running and suddenly he had a brilliant idea.
standards	picks	She picks up some blocks and dolls.	She picks standards up some blocks and dolls.
continue	things	Instead, he only printed out things about marriage.	Instead, he only printed out things continue about marriage.
events	bird	The bird told his friends about the root.	The bird events told his friends about the root.
why	He	He is humble and kind.	He why is humble and kind.
right	The	The dog wags his tail.	The right dog wags his tail.
sponsored	they	One day, they see a big dog in the park.	One day, they sponsored see a big dog in the park.
need	a	She felt like a princess.	She felt like a need princess.
server	was	Lily was sad.	Lily was server sad.
gift	in	Under the bed, in the kitchen, everywhere.	Under the bed, in gift the kitchen, everywhere.
words	strong	She stayed strong and brave.	She stayed strong words and brave.
general	was	Inside was a shiny pearl!	Inside was general a shiny pearl!
shop	outfit	Her best friend, Samantha, presented her with a safari outfit!	Her best friend, Samantha, presented her with a safari outfit shop!
engine	sand	Jill makes a castle with sand and sticks.	Jill makes a castle with sand engine and sticks.
human	Emma	Once upon a time, there was a girl named Emma.	Once upon a time, there was a girl named Emma human.
government	does	But Lily does not hear him.	But Lily does government not hear him.
fact	angry	He was angry and sad.	He was angry fact and sad.
planning	care	I don't care.	I don't care planning.
experience	there	She was so happy to be there!	She was so happy to be there experience!
kids	apple	Mark was so excited to get the apple.	Mark was so excited to get the apple kids.
cases	hot	The day was hot.	The day was hot cases.
programs	Max's	She is Max's mom.	She is Max's programs mom.
little	step	He didn't see the big hole near the step.	He didn't see the big hole near the step little.
court	is	It is fun.	It is court fun.
specific	with	They are happy with their picture.	They are happy with specific their picture.
edit	But	But he was too scared.	But edit he was too scared.
too	go	Come on, let's go home.	Come on, let's go too home.
one	something	She walked for a while and then she saw something.	She walked for a while and then she saw something one.
school	to	Lily understood and agreed not to pet the puppy.	Lily understood and agreed not to school pet the puppy.
later	to	They flew and crawled to the hive.	They flew and crawled to later the hive.
their	racers	After the race, the racers went to a big structure.	After the race, the racers their went to a big structure.
stories	a	So, Anne went outside and found a round wheel.	So, Anne went outside and found a stories round wheel.
working	lion	It was a lion!	It was a lion working!
age	the	Give me the wheel.	Give me the age wheel.
included	to	She is selfish and does not want to share.	She is selfish and does not want to included share.
hours	saw	She saw Lily with a guilty face.	She saw hours Lily with a guilty face.
solutions	through	Lea carefully sorted through the laundry.	Lea carefully sorted through solutions the laundry.
materials	â	Her dad beamed at her and said, â€œGood job, Lola.	Her dad beamed at her and said, â materials €œGood job, Lola.
year	ball	Ben and Mia look at the red ball.	Ben and Mia look at the red ball year.
prices	The	The dog was not nice and sometimes chased the kids.	The prices dog was not nice and sometimes chased the kids.
thing	are	Lila and Tom are friends.	Lila and Tom are thing friends.
security	The	The friends were really scared.	The security friends were really scared.
advertising	and	Carl left the mailman's house feeling happy and dizzy.	Carl left the mailman's house feeling happy and advertising dizzy.
off	made	The truck made a loud noise.	The truck made off a loud noise.
reading	and	She saw some dirt and grass stuck to the ball.	She saw some dirt and reading grass stuck to the ball.
never	old	Jake was three years old.	Jake was three years old never.
country	high	It was flying so high and so fast.	It was flying so high country and so fast.
either	didn't	But Tweety didn't want to give the meat back.	But Tweety didn't either want to give the meat back.
change	wool	They love to play with the wool.	They love to play with the wool change.
last	wanted	She wanted to see it again.	She wanted last to see it again.
due	lived	And they lived happily ever after.	And they lived due happily ever after.
window	and	Ben and Mia liked to play in the park.	Ben and window Mia liked to play in the park.
something	One	One day Lola decided to go on a walk.	One something day Lola decided to go on a walk.
fast	brilliant	She told him how brilliant he had been.	She told him how brilliant fast he had been.
must	was	But when they got there, it was very messy!	But when they got there, it was must very messy!
discount	them	She loved to wear dresses with pretty patterns on them.	She loved to wear dresses with pretty patterns on them discount.
family	kept	It kept jumping and nibbling at the radishes.	It kept family jumping and nibbling at the radishes.
risk	Everyone	Everyone was happy and cheerful.	Everyone risk was happy and cheerful.
company	a	Suddenly, a clap of thunder shook the sky.	Suddenly, a company clap of thunder shook the sky.
select	called	He smiled and called his mom.	He smiled and called select his mom.
estate	When	When his mommy finally came, Timmy was very excited.	When estate his mommy finally came, Timmy was very excited.
calendar	walked	As they walked, they saw a big, scary bear.	As they walked calendar, they saw a big, scary bear.
friends	When	When Mary was walking back home,she suddenly heard a voice.	When friends Mary was walking back home, she suddenly heard a voice.
message	dust	It made a cloud of dust.	It made a cloud of dust message.
regional	to	It needs to change a little more.	It needs to regional change a little more.
version	of	They saw a big pile of coal near the fence.	They saw a big pile of version coal near the fence.
being	it	Tom thinks about it.	Tom thinks about it being.
whole	Jack	Jack didn't know what to do.	Jack whole didn't know what to do.
delivery	excited	Lily was excited.	Lily was excited delivery.
several	says	He says he will get help.	He says several he will get help.
french	She	She was very happy because her wings were so tight.	She french was very happy because her wings were so tight.
log	was	It was not big anymore.	It was log not big anymore.
also	She	She thought mom would not notice.	She also thought mom would not notice.
want	Why	Why are you fighting?	Why want are you fighting?
function	hard	They said it was too hard.	They said it was too hard function.
commission	have	You have to respect my privacy.	You have commission to respect my privacy.
education	Lily's	It is not Lily's chalk.	It is not Lily's education chalk.
map	like	They like their ball.	They like map their ball.
and	musician	I am a musician too.	I am a musician and too.
water	real	She made a fake key and a real key.	She made a fake key and a real water key.
paul	and	Dolly the dough friend got warm and started to change.	Dolly the dough friend got warm and paul started to change.
center	to	Everyone was excited to see it!	Everyone was excited to center see it!
power	just	It was just perfect.	It was just power perfect.
change	roof	The bird landed on the temple roof.	The bird landed on the temple roof change.
town	his	He invited all his friends to join him.	He invited all his town friends to join him.
once	play	She did not want to play with him.	She did not want to play once with him.
high	boring	He thought it was boring and hard.	He thought it was boring high and hard.
info	a	Anna learned a lot of new words and facts.	Anna learned a info lot of new words and facts.
clear	him	She hugged him and scolded him.	She hugged him clear and scolded him clear.
buy	one	Then one day, something unexpected happened.	Then one buy day, something unexpected happened.
points	It	It is fun and good for you.	It points is fun and good for you.
loans	You	You are good children.	You loans are good children.
france	the	All the other animals welcomed her with a smile.	All the france other animals welcomed her with a smile.
file	were	Tim and the bird were very happy on their trip.	Tim and the bird were file very happy on their trip.
him	They	They saw a hose and turned it on.	They him saw a hose and turned it on.
edition	can	And we can give some to uncle too.	And we can edition give some to uncle too.
run	And	And they went back to playing together.	And run they went back to playing together.
description	scared	Tweet was scared of dogs.	Tweet was scared description of dogs.
offer	was	Sammy was feeling sad.	Sammy was offer feeling sad.
care	and	Max was happy and took the ball to play.	Max was happy and care took the ball to play.
stuff	to	Millie didn't know what to do.	Millie didn't know what to stuff do.
printer	big	They painted a big, beautiful rainbow together.	They painted a big printer, beautiful rainbow together.
windows	smiled	Lily nodded and smiled.	Lily nodded and smiled windows.
just	Lily	Lily shook her head.	Lily just shook her head.
they	The	The dog is big and black.	The they dog is big and black.
technology	what	Toby couldn't wait to see what was inside them.	Toby couldn't wait to see what technology was inside them.
period	there	Once upon a time, there was a tiny mouse.	Once upon a time, there period was a tiny mouse.
network	last	At last, they succeed!	At last network, they succeed!
written	disgusting	Alvin tasted it anyway, but it was disgusting!	Alvin tasted it anyway, but it was disgusting written!
now	into	John walked into his bedroom.	John walked into now his bedroom.
other	Ben	Ben and Mia are twins.	Ben other and Mia are twins.
microsoft	cheerful	You are very smart and cheerful.	You are very smart and cheerful microsoft.
electronics	of	She saw the fire and grabbed a bucket of water.	She saw the fire and grabbed a bucket of electronics water.
call	at	Tommy looked at Bella.	Tommy looked at call Bella.
important	But	But as she says it, she starts to giggle.	But important as she says it, she starts to giggle.
listings	The	The bird was scared and hurt.	The listings bird was scared and hurt.
against	learn	History is a story you can learn.	History is a story you can learn against.
text	Once	Once upon a time there was a rat.	Once text upon a time there was a rat.
bill	him	She helps him rebuild his tower.	She helps him bill rebuild his tower.
going	saw	He saw that his tent was broken!	He saw going that his tent was broken!
guide	great	He thought it was great fun.	He thought it was great guide fun.
many	Mittens	Lily smiled and petted Mittens.	Lily smiled and petted Mittens many.
notes	called	They called it their secret place.	They called notes it their secret place.
stock	laughing	She pulled it and pushed it, laughing and shouting.	She pulled it and pushed it, laughing stock and shouting.
can	so	It hopped around, feeling so shiny and full of energy.	It hopped around, feeling so can shiny and full of energy.
write	Rover	John and Rover collected stones and shells.	John and Rover write collected stones and shells.
living	very	They are very sad.	They are very living sad.
search	hands	They pat the dirt with their hands.	They pat the dirt with their hands search.
live	It	It is fun and fast.	It live is fun and fast.
india	and	She sees Anna and Ben.	She sees Anna and india Ben.
corporate	knew	He knew the bird would be scared too.	He knew corporate the bird would be scared too.
policies	are	You are a good dog.	You are policies a good dog.
content	They	They played fetch together and had lots of fun.	They content played fetch together and had lots of fun.
build	Tom	Tom is hurt.	Tom build is hurt.
church	day	One day, he saw a bird flying outside his cave.	One day church, he saw a bird flying outside his cave.
choose	the	Tom was happy and ran after the rabbit.	Tom was happy and ran after the choose rabbit.
film	so	It was so pretty!	It was so film pretty!
higher	When	When they got to the ocean, Ollie saw something incredible.	When higher they got to the ocean, Ollie saw something incredible.
commercial	thought	The bear thought for a moment.	The bear thought commercial for a moment.
newsletter	a	Once upon a time, there was a boy named Timmy.	Once upon a newsletter time, there was a newsletter boy named Timmy.
states	Every	Every night, it glowed more and more.	Every states night, it glowed more and more.
article	hold	They hold hands.	They hold article hands.
room	noise	The noise is from a car.	The noise room is from a car.
years	One	One day, they have a show and tell.	One years day, they have a show and tell.
reply	liked	Will liked to collect sticks.	Will liked reply to collect sticks.
across	happy	She was so happy!	She was so happy across!
jan	worked	She worked and worked until she was finished.	She worked jan and worked jan until she was finished.
status	could	So she asked her dad if she could keep it.	So she asked her dad if she could status keep it.
design	park	One day, Lily went for a walk in the park.	One day, Lily went for a walk in the park design.
protection	me	Please put me in my box.	Please put me protection in my box.
review	This	This made them unique and very important.	This review made them unique and very important.
while	on	He jumps on the chair.	He jumps on while the chair.
study	Lily	Lily and Sam never saw each other again.	Lily study and Sam never saw each other again.
bank	frosting	It has a white frosting.	It has a white frosting bank.
president	to	They wanted to eat turkey for dinner.	They wanted to president eat turkey for dinner.
hot	see	They wanted to see what was behind the door.	They wanted to see hot what was behind the door.
minutes	her	So, Amy decided to ask her mom.	So, Amy decided to ask her minutes mom.
several	It	It felt wonderful.	It several felt wonderful.
man	chest	She grabbed some of them and closed the chest.	She grabbed some of them and closed the chest man.
listing	them	She decided to teach them a lesson.	She decided to teach them listing a lesson.
discount	watched	Jane stopped and watched them fight.	Jane stopped and watched discount them fight.
internet	at	He was always trying to be the best at everything.	He was always trying to be the best at internet everything.
may	Ben	Lily and Ben were playing in the garden.	Lily and Ben may were playing in the garden.
window	and	She joins Lila and Tom in the port.	She joins Lila and window Tom in the port.
special	reach	The dog used the stick to reach the ball.	The dog used the stick to reach special the ball.
availability	was	He was bleeding and broken.	He was availability bleeding and broken.
bit	tree	It grew so much that it became a big tree.	It grew so much that it became a big tree bit.
centre	was	Once there was a yellow pistol.	Once there was centre a yellow pistol.
but	dad	After a few hours, John's dad finally fixed the leak.	After a few hours, John's dad but finally fixed the leak.
customer	it	But it is too late.	But it customer is too late.
talk	it	She hugs it.	She hugs it talk.
this	friends	Tom and Lily were friends.	Tom and Lily were friends this.
section	up	He climbs up the ladder and slides down.	He climbs up section the ladder and slides down.
author	her	She cried on her bed.	She cried on her author bed.
bill	as	The tree looked the same as before.	The tree looked the same as bill before.
better	That	That night, Tim had a dream.	That better night, Tim had a dream.
center	and	It started to shake and roar.	It started to shake and center roar.
videos	sun	The sun was shining bright in the sky.	The sun videos was shining bright in the sky.
subscribe	ran	They ran to the slide and waited for their turn.	They ran subscribe to the slide and waited for their turn.
type	worked	They saw a man who worked in the park.	They saw a man who worked type in the park.
photo	dodged	He dodged the sticks and the rocks.	He dodged photo the sticks and the rocks.
review	happy	Lily was happy and played with it all day.	Lily was happy review and played with it all day.
miles	scolded	She scolded them and took away all their toys.	She scolded miles them and took away all their toys.
been	Bobo	Bobo was always ready to play and have fun.	Bobo been was always ready to play and have fun.
tools	shell	They both pulled and tugged on the shell.	They both pulled and tugged on the shell tools.
better	pulled	She pulled and pulled.	She pulled better and pulled better.
nude	an	They both had to pick an object.	They both had to pick an nude object.
sales	was	He thought it was perfect for him.	He thought it was sales perfect for him.
annual	broke	It broke into pieces.	It broke annual into pieces.
major	He	He thought and thought.	He major thought and thought.
digital	cookie	Her mom sees the cookie.	Her mom sees the cookie digital.
problem	met	One day, she met a friendly hippo.	One day, she met problem a friendly hippo.
work	smile	They smile and go back to the camera.	They smile work and go back to the camera.
and	Balls	Balls, shoes, nets, cones, jerseys, and more.	Balls and, shoes, nets, cones, jerseys, and more.
terms	melted	Slowly, the ice melted more and more.	Slowly, the ice melted terms more and more.
plus	feel	He was starting to feel scared.	He was starting to feel plus scared.
include	It	It was an alligator!	It include was an alligator!
files	them	It could not hold them.	It could not hold them files.
research	an	You are an ancient bird.	You are an research ancient bird.
times	run	It couldn't fly or run anymore.	It couldn't fly or run times anymore.
events	into	They press the cookie cutters into the rice.	They press the cookie cutters into events the rice.
now	Her	Her mom still asked her to clean.	Her now mom still asked her to clean.
write	cheese	She went inside and found some crackers and cheese.	She went inside and found some crackers and cheese write.
title	the	First they swept the floors, then they washed the walls.	First they swept the title floors, then they washed the title walls.
learning	did	He did not need anyone else.	He did learning not need anyone else.
quick	a	They watched the leopard for a while.	They watched the leopard for a quick while.
law	not	They do not understand.	They do not law understand.
good	was	He kept counting until he was too tired.	He kept counting until he was good too tired.
united	They	They ran and hit the ball with all their might.	They united ran and hit the ball with all their might.
island	what	Her big sister came and saw what happened.	Her big sister came and saw what island happened.
story	dogs	They forget about their dogs.	They forget about their dogs story.
solutions	to	Tim loved to play catch with his red ball.	Tim loved to solutions play catch with his red ball.
jobs	They	They can't wait.	They jobs can't wait.
did	was	Once there was a little girl named Sally.	Once there was did a little girl named Sally.
too	let's	Now let's try to nap again.	Now let's too try to nap again.
need	Bobby	His Dad told Bobby to drive the bike.	His Dad told Bobby need to drive the bike.
sign	The	The frog and the bird played a game.	The sign frog and the bird played a game.
call	bike	Mia heard Sam's cry and stopped her bike.	Mia heard Sam's cry and stopped her bike call.
resources	saw	Donna saw an old lady at the ticket counter.	Donna saw resources an old lady at the ticket counter.
month	A	A man came running.	A month man came running.
nov	to	She wants to finish the puzzle.	She wants to nov finish the puzzle.
every	happy	They seemed very happy.	They seemed very happy every.
project	took	They took turns with the coin and enjoyed it together.	They took project turns with the coin and enjoyed it together.
thought	was	It was so cold that she shivered.	It was thought so cold that she shivered.
policy	potato	It is called a potato.	It is called a potato policy.
line	Sarah	So Sarah and her mum started to plan the party.	So Sarah line and her mum started to plan the party.
program	the	A loud noise scares the dog.	A loud noise scares the program dog.
discount	walk	He thought that maybe a nice walk would help.	He thought that maybe a nice walk discount would help.
york	quickly	He quickly ran back outside and found a puddle.	He quickly york ran back outside and found a puddle.
magazine	Anna	Anna agreed and helped him climb up.	Anna magazine agreed and helped him climb up.
remember	Tom	She gives Tom and Sue a slice each.	She gives Tom remember and Sue a slice each.
next	their	Lily and Tom nodded and closed their eyes.	Lily and Tom nodded and closed their next eyes.
between	very	One day, the car got very tired.	One day, the car got very between tired.
chat	Anna	Anna has a doll and Ben has a car.	Anna chat has a doll and Ben has a car.
university	teeth	The dog was black and had sharp teeth.	The dog was black and had sharp teeth university.
young	handed	Mommy handed the little boy some items from the basket.	Mommy handed young the little boy some items from the basket.
much	scared	Tom was scared.	Tom was scared much.
several	she	Maybe she is hiding somewhere.	Maybe she several is hiding somewhere.
put	then	But then he had a brilliant idea.	But then put he had a brilliant idea.
double	were	They were round blocks and square blocks.	They were double round blocks and square blocks.
once	to	Tom likes to move.	Tom likes to once move.
item	mommy	She loved to help her mommy in the kitchen.	She loved to help her mommy item in the kitchen.
marketing	She	She would never forget this magical day.	She marketing would never forget this magical day.
paul	was	Lily was thirsty and wanted some water.	Lily was paul thirsty and wanted some water.
estate	mom	Her mom gave them a bath.	Her mom estate gave them a bath.
why	The	The bird was gone.	The why bird was gone.
above	boy	Once there was a boy named Tim.	Once there was a boy above named Tim.
part	One	One day, she was playing hide-and-seek with her friend, Timmy.	One part day, she was playing hide-and-seek with her friend, Timmy.
european	had	She wished they had not forgotten.	She wished they had european not forgotten.
talk	He	He grabbed Tom by the hair.	He talk grabbed Tom by the hair.
god	flowers	She was going to water the flowers.	She was going to water the flowers god.
categories	dictionary	He loved the weird dictionary and used it every day!	He loved the weird dictionary categories and used it every day!
their	She	She saw their sad faces.	She their saw their sad faces.
ebay	not	He did not know what to do.	He did not ebay know what to do.
discount	her	The bear was friendly and smiled at her.	The bear was friendly and smiled at her discount.
government	Lily	Lily did not like the man.	Lily government did not like the man.
rates	took	They laughed and took turns talking into the bell.	They laughed and took rates turns talking into the bell.
provided	wear	I want to wear it in bed.	I want to wear provided it in bed.
analysis	It	It was clean and shiny.	It analysis was clean and shiny.
key	went	She went to a nearby garden and found a game.	She went key to a nearby garden and found a game.
administration	long	They played with the copper pot all day long.	They played with the copper pot all day long administration.
delivery	and	Lily and Tom are twins.	Lily and delivery Tom are twins.
october	play	They liked to play and hug and tell jokes.	They liked to play october and hug and tell jokes.
nature	not	The fish could not fly, but it could swim.	The fish could not nature fly, but it could swim.
whether	little	He saw a little mouse named Molly.	He saw a little whether mouse named Molly.
not	a	Soon enough, Mia felt a calmness come over her.	Soon enough, Mia felt a not calmness come over her.
house	away	He jumps off the fence and runs away.	He jumps off the fence and runs away house.
point	a	It was a big bottle of wine.	It was a point big bottle of wine.
topic	thank	He played a thank you song for the cat.	He played a thank topic you song for the cat.
city	a	We can teach you how to build a heart.	We can teach you how to build a city heart.
sure	not	But he was warned not to eat it.	But he was warned not sure to eat it.
summary	Lily	Lily had an idea.	Lily summary had an idea.
park	happy	He was happy.	He was happy park.
legal	She	She loved to play outside with her toys.	She legal loved to play outside with her toys.
printer	started	So Jake started to jog again.	So Jake started printer to jog again.
system	Ben	She removed them and gave them to Ben.	She removed them and gave them to Ben system.
small	They	They felt sad.	They small felt sad.
given	why	Suddenly, he realized why.	Suddenly, he realized why given.
black	Lily	It showed Lily a different image of herself.	It showed Lily black a different image of herself.
paper	to	And you have to wait for dinner.	And you have to paper wait for dinner.
australia	different	Today was different though.	Today was different australia though.
fast	careful	And you have to be careful with them.	And you have to be careful fast with them.
images	She	She bent down and tried to open the oyster.	She images bent down and tried to open the oyster.
see	the	They helped to load the branches.	They helped to load the see branches.
jul	very	Mommy watched over John as he slept, feeling very content.	Mommy watched over John as he slept, feeling very jul content.
send	their	Then, he gave Lila and Ben their toys back.	Then, he gave Lila and Ben their send toys back.
getting	But	But the hill was very steep.	But getting the hill was very steep.
more	creature	The creature was so happy!	The creature more was so happy!
into	Once	Once upon a time, there was a boy named Timmy.	Once into upon a time, there was a boy named Timmy.
michael	They	They take turns driving the train.	They michael take turns driving the train.
downloads	was	He was proud.	He was downloads proud.
conference	every	They talked and played together every day in the room.	They talked and played together every conference day in the room.
analysis	animals	They go back to their regular animals.	They go back to their regular animals analysis.
customer	not	He did not like it.	He did not customer like it.
amount	mean	He looked scary and mean.	He looked scary and mean amount.
though	you	Thank you, thank you!	Thank you though, thank you though!
tell	it	Now it was easier to fit the pieces together.	Now it tell was easier to fit the pieces together.
they	wait	He couldn't wait for the next winter adventure.	He couldn't wait they for the next winter adventure.
information	He	He thinks they are toys.	He information thinks they are toys.
found	ball	Sam kicks the ball to Ben.	Sam kicks the ball found to Ben.
estate	His	His mom smiled.	His estate mom smiled.
video	pretty	They were so pretty.	They were so pretty video.
designed	chair	She sees Tom on the chair.	She sees Tom on the chair designed.
science	seek	One day, they were playing hide and seek.	One day, they were playing hide and seek science.
oil	I	I love honey.	I oil love honey.
pictures	Mommy	Mommy was in the car with her little girl, Emily.	Mommy pictures was in the car with her little girl, Emily.
medical	They	They will make you healthy and strong.	They medical will make you healthy and strong.
remember	happy	They were all excited and happy.	They were all excited and happy remember.
language	Molly	Molly loved to draw!	Molly language loved to draw!
left	on	Sue had a mysterious itch on her arm.	Sue had a mysterious itch on left her arm.
second	prayed	She held Tommy in her arms and prayed.	She held Tommy in her arms and prayed second.
his	looked	It looked delicious.	It looked his delicious.
society	saw	When she looked closer, she saw it was a picture!	When she looked closer, she saw society it was a picture!
statement	what	They wondered what other mysteries the box had.	They wondered what statement other mysteries the box had.
top	Timmy	Timmy and his mom went back to their house.	Timmy top and his mom went back to their house.
category	happy	They are happy and full.	They are happy category and full.
other	smiled	She remembered this day and smiled.	She remembered this day and smiled other.
private	Mum	Mum and Dad were very proud of Daisy.	Mum private and Dad were very proud of Daisy.
resources	had	She had a plan.	She had resources a plan.
document	had	He had so much fun!	He had document so much fun!
technology	Sam	Jack and Sam were so sad.	Jack and Sam technology were so sad.
check	sigh	They look at each other and sigh.	They look at each other and sigh check.
unit	running	Lily said, running over to him.	Lily said, running unit over to him.
similar	four	Once upon a time, there was a family of four.	Once upon a time, there was a family of four similar.
none	He	He does not like his hair.	He none does not like his hair.
european	The	The plan worked.	The european plan worked.
old	ashamed	Tim felt ashamed.	Tim felt ashamed old.
through	happy	She was so happy.	She was so happy through.
percent	a	She had a skull that she always carried around.	She had a percent skull that she always carried around.
take	happy	The bird and the mouse were happy.	The bird and the mouse were happy take.
overall	Molly	Molly loved it!	Molly overall loved it!
sign	Ben	Ben felt cold and mad.	Ben sign felt cold and mad.
higher	is	The store is big and open.	The store is higher big and open.
screen	it	But it did not.	But it screen did not.
message	inside	Suddenly, a sound came from inside the volcano.	Suddenly, a sound came from inside message the volcano.
years	and	Sam was always obedient and Jack was not.	Sam was always obedient and years Jack was not.
movies	are	They are ours!	They are movies ours!
teen	line	She makes a line and a slash.	She makes a line teen and a slash.
monday	new	They make new friends.	They make new monday friends.
europe	pans	They used pots and pans and spoons and bowls.	They used pots and pans europe and spoons and bowls.
james	is	The dog is big and strong.	The dog is james big and strong.
policy	pretend	They cuddle together and pretend to sleep.	They cuddle together and pretend policy to sleep.
which	it	He felt it throughout the temple.	He felt it which throughout the temple.
this	orange	That's my orange.	That's my orange this.
this	never	They never saw the mushroom or the squirrel again.	They never this saw the mushroom or the squirrel again.
subject	back	Molly and Sarah ran back inside.	Molly and Sarah ran back subject inside.
copy	his	Timmy was scared and held onto his mom's hand tightly.	Timmy was scared and held onto his copy mom's hand tightly.
dog	and	The boy noticed the yellow bear and smiled.	The boy noticed the yellow bear and dog smiled.
april	hard	She worked so hard that soon the winter became warmer.	She worked so hard april that soon the winter became warmer.
double	hit	It made a big splash as it hit the water.	It made a big splash as it hit double the water.
international	not	Anna does not care.	Anna does not international care.
discount	But	But Jill said no, and they started to quarrel.	But discount Jill said no, and they started to quarrel.
final	was	The sky was very dark.	The sky was final very dark.
court	with	You can play with my clothes.	You can play with court my clothes.
into	Tom	Tom put them on first.	Tom into put them on first.
search	and	They hopped and skipped and tickled each other.	They hopped and search skipped and search tickled each other.
sep	harder	She tried harder, but still nothing.	She tried harder sep, but still nothing.
must	on	He sits on the slide.	He sits on must the slide.
yet	tiger	He saw a big tiger there.	He saw a big tiger yet there.
public	in	He asked, with a twinkle in his eye.	He asked, with a twinkle in public his eye.
center	the	Yes, we can finish the puzzle together.	Yes, we can finish the center puzzle together.
commercial	One	One day, Anna has a good idea.	One commercial day, Anna has a good idea.
want	enjoyed	They all sat down and enjoyed their picnic together.	They all sat down and enjoyed want their picnic together.
system	away	He walked away.	He walked away system.
related	gave	She gave them both a hug and a sandwich.	She gave related them both a hug and a sandwich.
higher	safe	They were safe.	They were safe higher.
low	One	One day, children went on a safari.	One low day, children went on a safari.
october	He	He sees the cars and the bikes.	He october sees the cars and the bikes.
our	cool	It was so cool!	It was so cool our!
sure	The	The cat was safe and Max's owner was very happy.	The sure cat was safe and Max's owner was very happy.
class	about	They forget about the remote.	They forget about class the remote.
base	enough	It was big enough for two.	It was big enough base for two.
over	had	They only had their ball.	They only had over their ball.
growth	seen	She had never seen anything like it before!	She had never seen growth anything like it before!
working	by	You can help us by being good and by praying.	You can help us by working being good and by working praying.
edition	their	They ask their mom.	They ask their edition mom.
watch	She	She went to her mom and told her the plan.	She watch went to her mom and told her the plan.
start	deer	Bear smiled and waved goodbye to the deer.	Bear smiled and waved goodbye to the deer start.
newsletter	Ravens	Ravens are nice birds.	Ravens newsletter are nice birds.
log	felt	He felt very proud of himself.	He felt log very proud of himself.
come	not	They are not friends.	They are not come friends.
common	He	He would pass by lots of houses.	He common would pass by lots of houses.
music	It	It was very painful and Timmy started to cry.	It music was very painful and Timmy started to cry.
japan	a	Everybody was eating and having a good time.	Everybody was eating and having a japan good time.
sales	girl	The girl laughed and smiled.	The girl sales laughed and smiled.
chapter	over	Lily's mom came over and saw what happened.	Lily's mom came over chapter and saw what happened.
her	the	As he walked to the mailbox, he felt something strange.	As he walked to the her mailbox, he felt something strange.
includes	excited	Anna was excited.	Anna was excited includes.
across	He	He was happy.	He across was happy.
meet	hoped	They hoped Jake would forgive them.	They hoped meet Jake would forgive them.
blog	sing	Timmy loved to sing and talk into his microphone.	Timmy loved to sing blog and talk into his microphone.
money	very	She was very sad.	She was very money sad.
manager	You	You will not whistle.	You manager will not whistle.
models	rough	The poor rabbits were trapped in the rough cage.	The poor rabbits were trapped in the rough models cage.
storage	asked	They were friendly and asked her what her name was.	They were friendly and asked storage her what her name was.
rock	little	Once, there was a little bird.	Once, there was a little rock bird.
york	a	One day, Anna decided to make a tunnel cake.	One day, Anna decided to make a york tunnel cake.
watch	It	It was made of plastic.	It watch was made of plastic.
file	the	He wanted to release the dove.	He wanted to release the file dove.
become	like	My dad has one like that.	My dad has one like become that.
stop	under	He put it under the chimney.	He put it under stop the chimney.
issues	time	Every time he shopped, he found something new and special.	Every time issues he shopped, he found something new and special.
data	a	The car driver wanted to take a look at it.	The car driver wanted to take a data look at it.
thought	girl	The girl was worried, but her dad wasn't worried.	The girl thought was worried, but her dad wasn't worried.
member	Some	Some mushrooms are good, but some are bad.	Some member mushrooms are good, but some are bad.
title	very	They all came running and were very excited.	They all came running and were very title excited.
him	to	They liked to run and jump and laugh.	They liked to him run and jump and laugh.
availability	strips	One day, she made some strips of paper.	One day, she made some strips availability of paper.
class	jogged	They jogged together, buzzing with energy.	They jogged class together, buzzing with energy.
companies	then	But then, she realized she was lost.	But then companies, she realized she was lost.
job	Lily	Lily and Ben were playing in the park.	Lily job and Ben were playing in the park.
when	smile	Ben and Mia stop crying and smile.	Ben and Mia stop crying and smile when.
had	named	Once there was a monkey named Tom.	Once there was a monkey named had Tom.
action	looked	She looked for another book that she liked.	She looked action for another book that she liked.
then	The	The monster smiled and waved as she left.	The then monster smiled and waved as she left.
building	not	Lily and Ben did not know what to do.	Lily and Ben did not building know what to do.
latest	that	She tells him that the dog just wanted to play.	She tells him that latest the dog just wanted to play.
county	them	She saw them fighting over the book.	She saw them county fighting over the book.
item	wanted	Molly said she wanted to fly.	Molly said she wanted item to fly.
double	agreed	And everyone agreed.	And everyone agreed double.
delivery	a	It belonged to a little boy named Jack.	It belonged to a delivery little boy named Jack.
light	and	After a while, Lily got tired and wanted to rest.	After a while, Lily got tired and light wanted to rest.
music	match	I found a match!	I found a match music!
any	songs	They all sang songs together.	They all sang songs any together.
was	was	I was not nice to you.	I was was not nice to you.
light	proud	Peter smiled too; he felt proud of himself.	Peter smiled too; he felt proud light of himself.
writing	with	He takes a picture of her with his toy camera.	He takes a picture of her with writing his toy camera.
latest	silver	He could feel the cool, silver water all around him.	He could feel the cool, silver latest water all around him.
download	park	One day, she went to the park with her mommy.	One day, she went to the park download with her mommy.
conditions	from	He came back from the market.	He came back from conditions the market.
which	was	Lily was sad.	Lily was which sad.
directory	a	They learned a hard lesson that day.	They learned a directory hard lesson that day.
administration	truck	The truck is very loud and fast.	The truck administration is very loud and fast.
hard	day	One day, Tom and Mandy were walking through the forest.	One day hard, Tom and Mandy were walking through the forest.
things	was	Her mom said yes and she was really excited.	Her mom said yes and she was things really excited.
york	her	Her daughter ran to her with a big hug.	Her daughter ran to her york with a big hug.
remember	played	They played and had fun.	They played remember and had fun.
jan	there	Once upon a time, there was a person.	Once upon a time, there jan was a person.
environmental	of	One day the kangaroo found a box of treats.	One day the kangaroo found a box of environmental treats.
created	his	Tom stopped his jog and was scared.	Tom stopped his created jog and was scared.
media	was	Once upon a time there was a black cow.	Once upon a time there was media a black cow.
problems	sees	She sees Ben and his fire truck.	She sees problems Ben and his fire truck.
bay	The	The flowers are pink and yellow.	The bay flowers are pink and yellow.
held	them	He did not want to give them back.	He did not want to give them held back.
time	flute	He grabbed her flute and ran away.	He grabbed her flute time and ran away.
power	play	I want to play.	I want to play power.
loans	did	Tom did not like to play with the other animals.	Tom did loans not like to play with the other animals.
bay	towards	He saw a big dog coming towards him.	He saw a big dog coming towards bay him.
natural	around	So he looked around for something else.	So he looked around natural for something else.
health	to	Lily loved to paint with her bright colors.	Lily loved to health paint with her bright colors.
groups	kitchen	Her mom was in the kitchen, making cookies.	Her mom was in the kitchen groups, making cookies.
technical	hole	She wonders what lives in the hole.	She wonders what lives in the hole technical.
states	But	But her sister only laughed.	But states her sister only laughed.
engineering	wanted	But they also wanted to run away.	But they also wanted engineering to run away.
write	there	Once upon a time, there was a girl named Lily.	Once upon a time, there write was a girl named Lily.
discount	was	She was also very curious.	She was discount also very curious.
ask	can	The fish said â€œI can help you escape!	The fish said â €œI can ask help you escape!
did	to	Sam and Lily were friends who liked to play outside.	Sam and Lily were friends who liked to did play outside.
wide	grandma	Her grandma had made cookies that smelled so good.	Her grandma wide had made cookies that smelled so good.
been	girl	The brave little girl smiled to herself.	The brave little girl been smiled to herself.
room	He	He went to a restaurant and asked for the menu.	He room went to a restaurant and asked for the menu.
over	careful	But be careful.	But be careful over.
called	things	Ben likes modern things too.	Ben likes modern things called too.
daily	saw	She saw her friend, Tom.	She saw daily her friend, Tom.
kids	lots	They played together every day and had lots of fun.	They played together every day and had lots kids of fun.
poker	and	Tim and Kim are scared.	Tim and poker Kim are scared.
west	car	She did not like the car.	She did not like the car west.
beauty	both	They both wanted the elephant.	They both beauty wanted the elephant.
heart	sad	Anna and Ben are sad and angry.	Anna and Ben are sad heart and angry.
period	The	The dog was barking and wagging its tail.	The period dog was barking and wagging its tail.
where	He	He is surprised and worried.	He where is surprised and worried.
hours	had	They felt sad and wished they had not traded.	They felt sad and wished they had hours not traded.
make	worked	He worked hard to make the best smiles for everyone.	He worked make hard to make the best smiles for everyone.
rights	difference	And that's how the small kiss made an enormous difference.	And that's how the small kiss made an enormous difference rights.
little	was	It was red and round.	It was little red and round.
god	branch	They held hands and climbed up the branch.	They held hands and climbed up the branch god.
natural	his	He heard the door open and his sister came home.	He heard the door open and his natural sister came home.
around	shovel	He picked up his shovel and hit the castle.	He picked up his shovel around and hit the castle.
student	peach	She did not know which fruit was a peach.	She did not know which fruit was a peach student.
pay	skin	I did not have a drum skin.	I did not have a drum skin pay.
made	She	She was very gentle and cared for him.	She made was very gentle and cared for him.
professional	one	Then they decided to play catch one more time.	Then they decided to play catch one professional more time.
friends	pick	She wants to pick one, but they are too high.	She wants to pick friends one, but they are too high.
works	around	She sprayed the can all around the kitchen in circles.	She sprayed the can all around works the kitchen in circles.
simple	with	Mia saw a big hill with a lot of flowers.	Mia saw a big hill with simple a lot of flowers.
pro	and	One day, he found a bow and arrow.	One day, he found a bow and pro arrow.
availability	His	His friends thought that was a great idea.	His availability friends thought that was a great idea.
states	away	He pushes Lily away.	He pushes Lily away states.
simple	each	Lily and Ben hug each other.	Lily and Ben hug each simple other.
start	wonderful	He couldn't believe how wonderful it smelled.	He couldn't believe how wonderful start it smelled.
sony	happy	Jane was happy that her cooler was safe.	Jane was happy sony that her cooler was safe.
save	Timmy	Timmy was nervous, but he said yes.	Timmy save was nervous, but he said yes.
the	she	When Fluffy found Sue, she would meow loudly.	When Fluffy found Sue, she the would meow loudly.
seller	felt	Tom and Mia felt bad.	Tom and Mia felt seller bad.
every	bear	She said the bear was bad and dangerous.	She said the bear every was bad and dangerous.
planning	not	He did not know who it was.	He did not planning know who it was.
those	to	But his favorite thing to make was a little igloo.	But his favorite thing to those make was a little igloo.
along	a	They learned a lesson.	They learned a along lesson.
availability	Uncle	Finally, Uncle Barry made it across town.	Finally, Uncle availability Barry made it across town.
pics	on	He feels the wind on his face and laughs.	He feels the wind on pics his face and laughs.
press	had	Some children had a ball and others had a kite.	Some children had press a ball and others had press a kite.
agency	good	He was recording the movie for a good reason.	He was recording the movie for a good agency reason.
privacy	what	Lily's mom came into the room and saw what happened.	Lily's mom came into the room and saw what privacy happened.
council	and	But Lily didn't listen and kept chasing the butterfly.	But Lily didn't listen and council kept chasing the butterfly.
needed	to	Once there was a caterpillar who wanted to measure things.	Once there was a caterpillar who wanted to needed measure things.
annual	She	She was very happy with it.	She annual was very happy with it.
build	was	Once there was a fine little girl named Sarah.	Once there was build a fine little girl named Sarah.
application	and	Suddenly, it broke and the boy fell off.	Suddenly, it broke and application the boy fell off.
photo	owner	The grandma was very happy and thanked the store owner.	The grandma was very happy and thanked the store owner photo.
provides	The	The swan was shy and hid behind some reeds.	The provides swan was shy and hid behind some reeds.
result	a	Then, he got a bright idea.	Then, he got a result bright idea.
