input1	input2	input3	label
is	gis	are	are
be	ben	remain	remain
are	seem	acre	seem
have	been	ave	been
more	monroe	less	less
was	were	wash	were
will	willow	must	must
home	residence	some	residence
can	could	ocean	could
page	prague	talk	talk
has	chaos	been	been
search	each	google	google
free	unlimited	reef	unlimited
other	there	various	various
do	dow	say	say
information	data	inflation	data
time	timber	period	period
site	sit	web	web
up	ups	down	down
may	may	might	might
news	announcement	nets	announcement
use	user	employ	employ
there	these	just	just
see	seven	hear	hear
so	anyway	iso	anyway
when	after	went	after
contact	visit	contractor	visit
business	unless	company	company
also	als	additionally	additionally
help	held	assistance	assistance
get	obtain	agent	obtain
online	outline	web	web
first	second	firms	second
am	jam	myself	myself
been	even	has	has
would	might	world	might
how	throw	what	what
were	was	where	was
service	rice	product	product
find	ind	locate	locate
price	cost	particle	cost
date	birth	dat	birth
back	bach	forward	forward
had	been	head	been
list	names	ist	names
state	started	federal	federal
year	month	ear	month
day	delay	week	week
email	fax	mil	fax
world	would	globe	globe
next	net	last	last
used	sought	usd	sought
go	proceed	geo	proceed
last	next	las	next
most	mst	many	many
buy	busy	sell	sell
data	statistics	dat	statistics
make	market	add	add
should	shoulder	must	must
system	stem	mechanism	mechanism
post	pos	reply	reply
add	daddy	remove	remove
policy	poly	strategy	strategy
please	lease	you	you
support	sort	backing	backing
message	warning	mesa	warning
best	beast	good	good
then	subsequently	teen	subsequently
good	goods	bad	bad
where	although	were	although
rights	freedom	wright	freedom
books	magazines	boost	magazines
high	highway	low	low
links	ins	references	references
years	months	buyers	months
order	alphabetical	rider	alphabetical
privacy	primary	confidentiality	confidentiality
items	its	foods	foods
company	comparing	business	business
read	bread	see	see
need	indeed	want	want
many	may	several	several
user	usher	admin	admin
said	told	aid	told
de	due	los	los
does	did	dos	did
set	seat	run	run
general	generator	specific	specific
mail	mainly	postage	postage
full	fell	complete	complete
reviews	viewers	publications	publications
life	lift	death	death
know	tell	snow	tell
days	dans	weeks	weeks
part	par	whole	whole
could	cloud	can	can
great	treat	tremendous	tremendous
united	separate	untitled	separate
real	oral	genuine	genuine
item	agenda	stem	agenda
international	instructional	domestic	domestic
center	inter	hub	hub
must	should	mst	should
store	shore	warehouse	warehouse
comments	remarks	cement	remarks
made	received	mad	received
report	resorts	findings	findings
details	info	retailers	info
line	linear	railway	railway
terms	conditions	ems	conditions
hotels	restaurants	votes	restaurants
send	sen	receive	receive
right	left	freight	left
local	vocal	nearby	nearby
using	sing	with	with
education	caution	school	school
national	animation	federal	federal
car	automobile	char	automobile
take	tank	give	give
posted	postage	received	received
internet	intent	web	web
address	identify	dress	identify
states	provinces	estate	provinces
area	bare	town	town
want	need	ant	need
phone	cell	one	cell
dvd	david	movie	movie
shipping	freight	hoping	freight
reserved	allocated	preserve	allocated
forum	blog	for	blog
family	fails	relatives	relatives
long	log	short	short
based	relying	basket	relying
code	zip	cod	zip
show	demonstrate	somehow	demonstrate
even	though	teen	though
check	verify	chuck	verify
prices	paris	commodity	commodity
website	homepage	bite	homepage
index	bibliography	indie	bibliography
being	beijing	somewhat	somewhat
women	girls	moment	girls
much	less	such	less
sign	ign	write	write
file	upload	five	upload
link	reference	blink	reference
open	pen	shut	shut
case	cape	anyway	anyway
project	protects	initiative	initiative
same	exactly	dame	exactly
pages	pas	links	links
version	vernon	model	model
own	their	down	their
found	pound	discovered	discovered
sports	supports	athletics	athletics
house	apartment	those	apartment
related	similar	rebate	similar
security	sexuality	homeland	homeland
county	sheriff	counter	sheriff
american	british	merchant	british
game	football	same	football
members	representatives	remember	representatives
power	per	authority	authority
care	are	health	health
network	infrastructure	artwork	infrastructure
down	off	don	off
computer	outer	laptop	laptop
systems	components	stem	components
total	portal	cumulative	cumulative
place	spot	pace	spot
end	wendy	start	start
following	after	floating	after
access	obtain	chess	obtain
think	believe	thin	believe
north	west	worthy	west
resources	restore	funds	funds
posts	blog	hosts	blog
media	press	median	press
control	influence	ontario	influence
water	after	liquid	liquid
art	apart	music	music
personal	prison	intimate	intimate
guide	ide	assist	assist
shop	cafe	hope	cafe
directory	listings	direction	listings
board	keyboards	directors	directors
location	site	latina	site
change	adjust	charges	adjust
white	black	while	black
small	large	mall	large
rating	treating	assessment	assessment
rate	speed	rare	speed
usa	susan	america	america
return	creature	leave	leave
students	faculty	sudden	faculty
shopping	mall	hoping	mall
account	counts	log	log
times	occasions	timber	occasions
sites	its	locations	locations
level	threshold	cleveland	threshold
profile	characteristics	pole	characteristics
form	shape	fort	shape
events	timeline	even	timeline
old	would	new	new
john	paul	join	paul
main	mating	central	central
call	mall	say	say
hours	chorus	days	days
non	multi	nikon	multi
insurance	health	entrance	health
shall	must	hall	must
class	las	middle	middle
still	skill	now	now
money	monterey	cash	cash
quality	assurance	quit	assurance
listing	string	entry	entry
content	constant	material	material
country	state	counter	state
little	title	nothing	nothing
visit	vista	attend	attend
save	protect	slave	protect
tools	too	techniques	techniques
low	high	flow	high
reply	answer	rep	answer
compare	compaq	examine	examine
movies	film	moved	film
include	nude	add	add
college	collected	university	university
article	section	arctic	section
man	guy	many	guy
provide	pride	deliver	deliver
food	flood	meals	meals
press	media	presents	media
learn	len	know	know
sale	auction	scale	auction
print	point	copy	copy
course	semester	mouse	semester
canada	usa	calendar	usa
teen	youth	then	youth
room	house	root	house
stock	soc	shares	shares
training	ranking	skills	skills
too	pretty	tokyo	pretty
credit	edit	loans	loans
point	paint	view	view
join	participate	joan	participate
science	since	technology	technology
men	boys	menu	boys
advanced	sophisticated	dance	sophisticated
sales	marketing	scales	marketing
look	logo	take	take
estate	state	property	property
conditions	contains	terms	terms
select	electro	pick	pick
windows	wins	glass	glass
thread	discussion	threatened	discussion
week	seek	month	month
live	olive	perform	perform
large	are	small	small
gallery	gale	exhibition	exhibition
register	either	declare	declare
market	marked	industry	industry
really	obviously	early	obviously
action	tion	response	response
start	begin	sat	begin
series	users	character	character
model	prototype	del	prototype
features	functionality	fears	functionality
air	pollution	dairy	pollution
plan	pan	strategy	strategy
provided	providence	sought	sought
required	necessary	retired	necessary
second	scotland	third	third
hot	cold	photo	cold
accessories	toys	accessed	toys
cost	cst	expense	expense
movie	film	moved	film
forums	discussions	form	discussions
march	marc	protest	protest
la	une	ala	une
better	worse	letter	worse
questions	answers	versions	answers
going	went	ing	went
medical	psychiatric	dial	psychiatric
test	est	diagnostic	diagnostic
come	bring	com	bring
server	client	severe	client
pc	linux	pmc	linux
study	research	stud	research
cart	horse	chart	horse
articles	particle	editors	editors
play	role	poly	role
looking	cooking	thought	thought
issues	tissue	problems	problems
never	rarely	severe	rarely
users	people	sears	people
complete	complexity	full	full
street	boulevard	reset	boulevard
topic	subject	pic	subject
comment	common	remark	remark
things	this	ways	ways
working	boring	employed	employed
person	pension	guy	guy
less	more	bless	more
blog	long	forum	forum
party	partly	election	election
payment	fee	apartment	fee
login	password	lin	password
student	sent	teacher	teacher
let	know	fleet	know
offers	presents	offense	presents
legal	constitutional	leg	constitutional
recent	crescent	previous	previous
park	zoo	spark	zoo
stores	retailer	stress	retailer
side	idea	front	front
act	acute	perform	perform
problem	solution	pole	solution
red	blue	breed	blue
give	live	take	take
memory	ram	merry	ram
performance	france	achievement	achievement
language	syntax	manage	syntax
story	tale	statutory	tale
sell	buy	cell	buy
options	tion	menu	menu
rates	gates	incidence	incidence
create	rebate	build	build
body	soul	anybody	soul
young	you	talented	talented
america	usa	camera	usa
important	crucial	imports	crucial
field	area	fed	area
east	north	est	north
paper	par	ink	ink
age	years	image	years
example	instance	exam	instance
girls	boys	gis	boys
additional	extra	addiction	extra
password	assorted	login	login
latest	upcoming	later	upcoming
something	sporting	really	really
road	read	highway	highway
changes	improvements	chargers	improvements
night	day	insights	day
ca	cam	approx	approx
hard	heard	tough	tough
poker	gambling	spoke	gambling
status	startup	privileges	privileges
browse	download	rose	download
issue	problem	tissue	problem
range	scope	rangers	scope
seller	smaller	manufacturer	manufacturer
court	tribunal	scout	tribunal
always	ways	never	never
result	consequence	rest	consequence
audio	recordings	auditor	recordings
light	fight	dark	dark
offer	officer	accept	accept
groups	gross	individuals	individuals
al	ben	alt	ben
easy	quick	seas	quick
files	documents	fails	documents
event	even	occurrence	occurrence
release	please	publication	publication
china	chain	japan	japan
making	main	with	with
needs	seeds	ought	ought
possible	necessary	fossil	necessary
might	could	light	could
professional	possession	amateur	amateur
month	week	monte	week
major	significant	manor	significant
star	celebrity	start	celebrity
areas	locations	andreas	locations
future	furniture	upcoming	upcoming
space	room	sauce	room
hand	fingers	khan	fingers
cards	deck	car	deck
london	onion	westminster	westminster
meeting	seeing	attendance	attendance
become	welcome	have	have
interest	interstate	conflict	conflict
keep	jeep	maintain	maintain
enter	center	join	join
porn	poor	erotic	erotic
share	shore	contribute	contribute
similar	seminar	different	different
added	ladder	contributed	contributed
reference	florence	citation	citation
companies	accompanied	firms	firms
listed	referenced	instead	referenced
learning	earnings	cognitive	cognitive
energy	entry	heat	heat
run	round	operate	operate
delivery	mail	every	mail
popular	pour	widespread	widespread
term	phrase	tier	phrase
stories	restore	legends	legends
computers	complete	laptop	laptop
reports	imports	findings	findings
co	cio	ltd	ltd
try	attempt	troy	attempt
welcome	pleased	become	pleased
central	rental	main	main
images	photos	wages	photos
president	ceo	presently	ceo
notice	nice	effect	effect
head	had	neck	neck
cell	phones	fell	phones
color	black	colon	black
away	airways	off	off
includes	consists	clouds	consists
archive	achieved	discussion	discussion
once	again	nice	again
others	individuals	another	individuals
entertainment	testament	music	music
agreement	accord	basement	accord
format	style	flora	style
least	one	beast	one
months	weeks	monsters	weeks
log	logos	entry	entry
sure	survey	afraid	afraid
trade	grande	business	business
edition	book	tion	book
cars	cas	automobiles	automobiles
marketing	sales	treating	sales
tell	dell	say	say
further	additional	father	additional
association	membership	citation	membership
able	willing	table	willing
having	with	hang	with
provides	allows	provinces	allows
david	avoid	james	james
fun	fund	enjoyable	enjoyable
studies	research	dies	research
close	loose	shut	shut
common	widespread	comment	widespread
drive	push	div	push
several	server	numerous	numerous
living	dead	diving	dead
called	allied	referred	referred
short	resort	long	long
arts	sciences	hart	sciences
ask	task	question	question
limited	minimal	lime	minimal
powered	built	powers	built
means	mas	way	way
director	directv	manager	manager
daily	bailey	regular	regular
beach	shore	each	shore
past	paste	current	current
due	duke	resulting	resulting
et	yet	qui	qui
period	proud	time	time
planning	playing	strategic	strategic
says	essays	thinks	thinks
weather	whether	rain	rain
land	and	property	property
average	typical	savage	typical
done	one	undertaken	undertaken
window	opportunity	winds	opportunity
france	franchise	australia	australia
pro	anti	probe	anti
region	begin	city	city
record	set	restored	set
direct	via	directv	via
conference	concerned	symposium	symposium
environment	atmosphere	enrollment	atmosphere
records	regards	documents	documents
st	sat	paul	paul
district	strict	town	town
calendar	cedar	events	events
costs	fees	hosts	fees
style	format	stolen	format
update	plate	fix	fix
parts	paris	component	component
ever	even	hardly	hardly
early	realty	late	late
sound	noise	bound	noise
resource	allocation	restored	allocation
present	examine	pest	examine
ago	years	cargo	years
document	cement	pdf	pdf
works	worst	paintings	paintings
material	martial	stuff	stuff
bill	legislation	fill	legislation
written	published	rotten	published
hosting	string	venue	venue
rules	unless	governing	governing
adult	teenage	fault	teenage
thing	stuff	thin	stuff
centre	entries	hub	hub
cheap	inexpensive	cap	inexpensive
nude	node	topless	topless
true	tue	false	false
minutes	mint	seconds	seconds
else	anything	chelsea	anything
mark	anniversary	markets	anniversary
third	second	thread	second
gifts	donations	its	donations
europe	britain	rope	britain
reading	book	breeding	book
topics	tops	subjects	subjects
bad	band	good	good
tips	advice	ips	advice
auto	nato	car	car
cover	illustrate	cove	illustrate
edit	summary	credit	summary
videos	provides	photographs	photographs
percent	recent	billion	billion
fast	slow	past	slow
fact	indeed	fat	indeed
getting	really	settings	really
tech	geek	each	geek
meet	mere	satisfy	satisfy
economic	comics	social	social
en	route	pen	route
player	team	later	team
projects	initiatives	protects	initiatives
often	rotten	usually	usually
subscribe	buy	describe	buy
submit	summit	send	send
germany	usa	granny	usa
amount	percentage	mounted	percentage
watch	listen	witch	listen
included	indeed	brought	brought
feel	fee	think	think
bank	rank	deposits	deposits
risk	danger	iris	danger
thanks	trans	grateful	grateful
deals	agreements	ideal	agreements
linux	lin	freebsd	freebsd
james	paul	games	paul
weight	might	lbs	lbs
heart	chart	soul	soul
advertising	rising	publicity	publicity
received	sent	receiver	sent
choose	opt	chromosome	opt
newsletter	hewlett	publication	publication
archives	library	achieve	library
points	areas	paint	areas
magazine	newspaper	gained	newspaper
error	mistakes	terrorist	mistakes
construction	development	instructor	development
clear	obvious	nuclear	obvious
receive	send	directive	send
domain	realm	main	realm
chapter	cheaper	book	book
makes	markets	considers	considers
protection	safety	protein	safety
policies	reforms	polish	reforms
loan	lan	payday	payday
wide	broad	ide	broad
manager	supervisor	danger	supervisor
india	usa	linda	usa
position	proposition	job	job
taken	shown	talent	shown
sort	kind	shorts	kind
listings	directory	lifting	directory
models	meals	versions	versions
known	referred	own	referred
half	dozen	hal	dozen
cases	situations	scales	situations
step	forward	sep	forward
simple	samples	easy	easy
quick	buick	easy	easy
none	either	once	either
license	lies	permission	permission
paul	pal	james	james
lake	take	pond	pond
whole	entire	while	entire
later	subsequently	plate	subsequently
basic	basin	fundamental	fundamental
shows	indicates	shorts	indicates
corporate	governmental	reported	governmental
active	prominent	katie	prominent
response	respondent	feedback	feedback
practice	theory	particle	theory
hardware	equipment	aware	equipment
figure	failure	estimate	estimate
materials	products	martial	products
fire	burning	figure	burning
chat	messaging	that	messaging
designed	undefined	built	built
death	depth	dying	dying
writing	book	listing	book
speed	velocity	see	velocity
countries	continues	people	people
loss	lots	defeat	defeat
face	ace	pose	pose
brand	marketing	band	marketing
discount	scout	purchase	purchase
higher	low	fighter	low
created	related	founded	founded
remember	member	forget	forget
bit	somewhat	built	somewhat
yellow	hello	red	red
increase	boost	incest	boost
advertise	adviser	publish	publish
base	core	babe	core
thought	though	believed	believed
french	italian	reach	italian
storage	warehouse	sage	warehouse
japan	jan	usa	usa
doing	din	work	work
loans	investments	los	investments
shoes	pants	shore	pants
entry	listing	ent	listing
stay	remain	say	remain
nature	mature	kind	kind
orders	border	instructions	instructions
africa	maria	europe	europe
turn	take	saturn	take
mean	men	say	say
notes	says	voters	says
king	queen	working	queen
copy	cop	paste	paste
pics	photo	pcs	photo
western	webmaster	oriental	oriental
income	earnings	come	earnings
force	task	florence	task
cash	money	cas	money
employment	moment	jobs	jobs
overall	oval	efficiency	efficiency
commission	common	report	report
ad	and	advertisement	advertisement
package	bundle	cage	bundle
contents	opponents	material	material
seen	heard	teen	heard
players	prayer	musicians	musicians
engine	nine	motors	motors
port	ship	poor	ship
stop	prevent	soap	prevent
supplies	spies	goods	goods
started	began	state	began
administration	demonstration	government	government
institute	research	substitute	research
plans	planets	strategies	strategies
double	twice	adobe	twice
dog	doing	puppy	puppy
build	develop	guild	develop
screen	computer	crescent	computer
types	kinds	tapes	kinds
lines	paragraphs	mines	paragraphs
continue	container	proceed	proceed
needed	sought	needle	sought
apply	apple	utilize	utilize
held	took	shield	took
anything	else	acting	else
printer	inter	desktop	desktop
condition	disease	contributions	disease
effective	executives	successful	successful
believe	think	eleven	think
asked	told	based	told
mind	ind	thoughts	thoughts
selection	choice	sections	choice
casino	canon	poker	poker
lost	recovered	lot	recovered
tour	your	visit	visit
menu	men	restaurant	restaurant
cross	css	border	border
anyone	annex	somebody	somebody
mortgage	lender	orange	lender
hope	wish	shop	wish
corporation	coordination	entity	entity
wish	with	want	want
solution	bolton	problem	problem
mature	feature	young	young
role	rose	position	position
rather	less	leather	less
addition	addiction	plus	plus
came	went	camel	went
nothing	little	clothing	little
certain	specific	curtain	specific
executive	officer	expected	officer
running	kept	ruling	kept
lower	high	flower	high
necessary	essay	sufficient	sufficient
union	rugby	onion	rugby
according	says	accord	says
clothing	nothing	apparel	apparel
fine	finger	okay	okay
names	lists	nas	lists
hour	honour	day	day
gas	oil	gas	oil
skills	kill	knowledge	knowledge
bush	george	buys	george
islands	sans	beaches	beaches
advice	suggestions	dice	suggestions
career	life	care	life
military	naval	similarly	naval
rental	oriental	housing	housing
decision	detection	choice	choice
leave	send	level	send
british	american	critics	american
pre	non	prize	non
huge	enormous	hughes	enormous
sat	looked	salt	looked
woman	lady	wan	lady
bid	blind	auction	auction
kind	sort	ind	sort
sellers	useless	ebay	ebay
middle	idle	upper	upper
cable	scale	wire	wire
taking	parking	over	over
values	traditions	wales	traditions
division	admission	department	department
coming	back	coding	back
appropriate	necessary	appropriations	necessary
machine	matched	computer	computer
logo	log	image	image
actually	virtually	never	never
nice	ice	lovely	lovely
score	stored	game	game
statistics	artistic	data	data
client	incident	server	server
ok	nice	oak	nice
capital	captain	investment	investment
follow	adopt	fellow	adopt
sample	analysis	sale	analysis
sent	dispatched	sen	dispatched
shown	demonstrated	how	demonstrated
england	britain	engaged	britain
band	ban	group	group
flash	pan	ash	pan
ms	mls	seconds	seconds
lead	load	take	take
george	merge	james	james
choice	preference	chronicle	preference
went	wet	came	came
starting	begun	strings	begun
registration	fee	illustration	fee
courses	golf	courtesy	golf
consumer	costume	product	product
hi	him	hello	hello
levels	concentrations	leeds	concentrations
letter	memorandum	better	memorandum
mode	aspect	mod	aspect
phones	cell	honest	cell
ideas	thoughts	ids	thoughts
fund	invest	found	invest
allow	require	alloy	require
contract	contrast	agreement	agreement
wed	marriage	weed	marriage
male	gender	sale	gender
matter	mate	issue	issue
took	hook	gave	gave
located	near	load	near
asian	san	europe	europe
distribution	packaging	distinction	packaging
inn	hotel	inner	hotel
industrial	install	economic	economic
cause	effect	case	effect
potential	pontiac	implications	implications
song	lyrics	strong	lyrics
los	que	close	que
hp	hop	watts	watts
late	early	plate	early
fall	ball	spring	spring
featured	mature	showcase	showcase
idea	notion	tide	notion
rooms	suites	rom	suites
responsible	competent	responses	competent
communications	wireless	compilation	wireless
win	winds	victory	victory
associated	corresponding	located	corresponding
primary	pray	sole	sole
cancer	prostate	cancel	prostate
numbers	totals	consumers	totals
tool	weapon	toll	weapon
browser	rose	firefox	firefox
spring	scoring	autumn	autumn
answer	question	laser	question
voice	singing	ice	singing
communication	messages	compilation	messages
purpose	intent	rose	intent
feature	futures	characteristic	characteristic
bed	based	sleep	sleep
comes	brings	codes	brings
police	detective	pole	detective
independent	indeed	reliable	reliable
ip	user	rip	user
cameras	came	photography	photography
maps	regions	caps	regions
medicine	pharmacology	median	pharmacology
deal	agreement	dental	agreement
hold	should	take	take
ratings	creating	popularity	popularity
forms	shapes	firms	shapes
glass	bottle	gas	bottle
happy	glad	apply	glad
smith	sixth	james	james
wanted	chose	granted	chose
developed	developers	built	built
thank	appreciate	tan	appreciate
safe	comfortable	same	comfortable
survey	surely	poll	poll
prior	prison	subsequent	subsequent
telephone	leone	fax	fax
sport	supports	athletics	athletics
ready	relay	willing	willing
feed	hungry	fed	hungry
sources	ensures	reliable	reliable
regular	occasional	regulatory	occasional
secure	cure	obtain	obtain
navigation	ships	variation	ships
ass	mass	butt	butt
evidence	residence	proof	proof
station	tion	railway	railway
christian	muslim	criteria	muslim
round	grounds	bye	bye
option	possibility	tion	possibility
master	mastercard	grand	grand
valley	valve	mountains	mountains
recently	noticed	crescent	noticed
probably	probability	definitely	definitely
rentals	condo	oriental	condo
sea	waters	speak	waters
built	but	constructed	constructed
cut	cult	trim	trim
connection	ties	corrections	ties
hall	all	room	room
larger	small	charger	small
anti	pro	ati	pro
earth	soil	deaths	soil
parents	percent	kids	kids
transfer	trainer	move	move
kitchen	bathroom	then	bathroom
strong	song	weak	weak
wedding	adding	bride	bride
properties	proper	buildings	buildings
hospital	spiritual	clinic	clinic
ground	around	floor	floor
ship	vessel	sip	vessel
owners	powers	executives	executives
excellent	excel	superb	superb
paid	aid	offered	offered
perfect	ideal	effects	ideal
hair	air	blond	blond
basis	bass	grounds	grounds
command	recommends	leadership	leadership
express	communicate	expenses	communicate
anal	ana	sex	sex
award	aware	prize	prize
distance	length	trance	length
tree	oak	three	oak
ensure	facilitate	leisure	facilitate
thus	consequently	thu	consequently
wall	all	brick	brick
ie	die	whereas	whereas
extra	additional	era	additional
partners	porter	clients	clients
rated	given	related	given
guides	manual	guest	manual
ma	mac	dis	dis
existing	new	eating	new
quite	equity	pretty	pretty
selected	delete	chosen	chosen
amazon	among	ebay	ebay
patients	pants	doctors	doctors
warning	threat	earnings	threat
wine	beer	win	beer
locations	sites	emotions	sites
horse	those	pony	pony
vote	volt	election	election
forward	back	reward	back
flowers	garden	owners	garden
stars	start	celebrities	celebrities
significant	infant	considerable	considerable
lists	names	its	names
owner	longer	publisher	publisher
animals	creatures	analyst	creatures
directly	via	directv	via
est	best	qui	qui
son	soon	daughter	daughter
providing	with	pricing	with
mac	linux	march	linux
housing	using	apartments	apartments
takes	brings	taxes	brings
bring	come	boring	come
searches	google	sears	google
trying	string	able	able
mother	son	other	son
considered	thought	consolidated	thought
told	old	said	said
joined	left	jones	left
input	put	feedback	feedback
feet	inches	free	inches
agent	officer	gen	officer
valid	legitimate	aid	legitimate
bin	laden	blind	laden
modern	traditional	modeling	traditional
senior	sensor	young	young
teaching	facing	classroom	classroom
door	gate	poor	gate
grand	magnificent	rand	magnificent
testing	development	treating	development
trial	tribal	prosecution	prosecution
charge	cage	fee	fee
units	its	divisions	divisions
instead	simply	steady	simply
cool	warm	col	warm
wrote	route	published	published
ships	boats	his	boats
entire	whole	tire	whole
leading	prominent	landing	prominent
metal	copper	meta	copper
positive	posted	strong	strong
fitness	finest	health	health
chinese	chains	russian	russian
opinion	views	pension	views
abstract	conceptual	attract	conceptual
uses	buses	allows	allows
funds	finds	money	money
greater	less	easter	less
likely	probably	lily	probably
processing	profession	storage	storage
guest	celebrity	get	celebrity
seems	seeds	looks	looks
publication	republicans	journal	journal
pass	fail	pas	fail
relations	affair	elevation	affair
trust	trucks	confidence	confidence
contains	conditions	produces	produces
session	possession	conference	conference
fees	tuition	feel	tuition
components	systems	opponents	systems
vacation	variation	holiday	holiday
century	decades	venture	decades
completed	completely	finished	finished
skin	asking	hair	hair
indian	european	finding	european
ads	adds	campaign	campaign
expected	likely	repeated	likely
ring	bell	ing	bell
dating	boyfriend	updating	boyfriend
mountain	hill	contain	hill
filter	mesh	after	mesh
mailing	postage	sailing	postage
longer	blogger	still	still
consider	regard	consumer	regard
int	char	mint	char
northern	coastal	rather	coastal
panel	committee	plane	committee
floor	ceiling	for	ceiling
german	sherman	swedish	swedish
buying	using	purchase	purchase
match	patch	win	win
default	faculty	option	option
require	enquiries	allow	allow
boys	girls	bios	girls
deep	dept	shallow	shallow
morning	day	earning	day
otherwise	there	unless	unless
allows	encourages	lows	encourages
rest	lay	est	lay
protein	antibody	protecting	antibody
plant	planets	flower	flower
reported	claimed	repeated	claimed
hit	haiti	struck	struck
transportation	translations	logistics	logistics
pool	poor	swimming	swimming
mini	mega	mining	mega
boards	towards	committees	committees
faculty	students	fault	students
parties	paris	clubs	clubs
fish	salmon	fits	salmon
mission	issn	objectives	objectives
string	sharing	rope	rope
pack	bags	pace	bags
released	related	found	found
stage	productions	strange	productions
internal	intent	domestic	domestic
goods	woods	merchandise	merchandise
recommended	recorded	asked	asked
born	boring	married	married
detailed	retailer	comprehensive	comprehensive
race	ethnicity	rare	ethnicity
background	around	perspective	perspective
target	treat	hit	hit
character	series	chargers	series
functions	fiction	tasks	tasks
ed	ing	red	ing
moving	smoking	forward	forward
brands	rand	outlets	outlets
places	pace	things	things
trademarks	copyrights	remarks	copyrights
southern	bother	central	central
winter	autumn	winner	autumn
rape	rap	assault	assault
battery	latter	lithium	lithium
youth	you	teens	teens
pressure	tension	treasure	tension
submitted	forwarded	subcommittee	forwarded
incest	rape	invest	rape
debt	loans	debut	loans
television	revision	radio	radio
interested	interstate	keen	keen
core	fundamental	scores	fundamental
