input1	label
t h e	the
a n d	and
f o r	for
t h a t	that
t h i s	this
w i t h	with
y o u	you
n o t	not
a r e	are
f r o m	from
y o u r	your
a l l	all
h a v e	have
n e w	new
m o r e	more
w a s	was
w i l l	will
h o m e	home
c a n	can
a b o u t	about
p a g e	page
h a s	has
s e a r c h	search
f r e e	free
b u t	but
o u r	our
o n e	one
o t h e r	other
i n f o r m a t i o n	information
t i m e	time
t h e y	they
s i t e	site
m a y	may
w h a t	what
w h i c h	which
t h e i r	their
n e w s	news
o u t	out
u s e	use
a n y	any
t h e r e	there
s e e	see
o n l y	only
h i s	his
w h e n	when
c o n t a c t	contact
h e r e	here
b u s i n e s s	business
w h o	who
w e b	web
a l s o	also
n o w	now
h e l p	help
g e t	get
v i e w	view
o n l i n e	online
f i r s t	first
b e e n	been
w o u l d	would
h o w	how
w e r e	were
s e r v i c e s	services
s o m e	some
t h e s e	these
c l i c k	click
i t s	its
l i k e	like
s e r v i c e	service
t h a n	than
f i n d	find
p r i c e	price
d a t e	date
b a c k	back
t o p	top
p e o p l e	people
h a d	had
l i s t	list
n a m e	name
j u s t	just
o v e r	over
s t a t e	state
y e a r	year
d a y	day
i n t o	into
e m a i l	email
t w o	two
h e a l t h	health
w o r l d	world
n e x t	next
u s e d	used
w o r k	work
l a s t	last
m o s t	most
p r o d u c t s	products
m u s i c	music
b u y	buy
d a t a	data
m a k e	make
t h e m	them
s h o u l d	should
p r o d u c t	product
s y s t e m	system
p o s t	post
h e r	her
c i t y	city
a d d	add
p o l i c y	policy
n u m b e r	number
s u c h	such
p l e a s e	please
a v a i l a b l e	available
c o p y r i g h t	copyright
s u p p o r t	support
m e s s a g e	message
a f t e r	after
b e s t	best
s o f t w a r e	software
t h e n	then
j a n	jan
g o o d	good
v i d e o	video
w e l l	well
w h e r e	where
i n f o	info
r i g h t s	rights
p u b l i c	public
b o o k s	books
h i g h	high
s c h o o l	school
t h r o u g h	through
e a c h	each
l i n k s	links
s h e	she
r e v i e w	review
y e a r s	years
o r d e r	order
v e r y	very
p r i v a c y	privacy
b o o k	book
i t e m s	items
c o m p a n y	company
r e a d	read
g r o u p	group
s e x	sex
n e e d	need
m a n y	many
u s e r	user
s a i d	said
d o e s	does
s e t	set
u n d e r	under
g e n e r a l	general
r e s e a r c h	research
u n i v e r s i t y	university
j a n u a r y	january
m a i l	mail
f u l l	full
m a p	map
r e v i e w s	reviews
p r o g r a m	program
l i f e	life
k n o w	know
g a m e s	games
w a y	way
d a y s	days
m a n a g e m e n t	management
p a r t	part
c o u l d	could
g r e a t	great
u n i t e d	united
h o t e l	hotel
r e a l	real
i t e m	item
i n t e r n a t i o n a l	international
c e n t e r	center
e b a y	ebay
m u s t	must
s t o r e	store
t r a v e l	travel
c o m m e n t s	comments
m a d e	made
d e v e l o p m e n t	development
r e p o r t	report
o f f	off
m e m b e r	member
d e t a i l s	details
l i n e	line
t e r m s	terms
b e f o r e	before
h o t e l s	hotels
d i d	did
s e n d	send
r i g h t	right
t y p e	type
b e c a u s e	because
l o c a l	local
t h o s e	those
u s i n g	using
r e s u l t s	results
o f f i c e	office
e d u c a t i o n	education
n a t i o n a l	national
c a r	car
d e s i g n	design
t a k e	take
p o s t e d	posted
i n t e r n e t	internet
a d d r e s s	address
c o m m u n i t y	community
w i t h i n	within
s t a t e s	states
a r e a	area
w a n t	want
p h o n e	phone
d v d	dvd
s h i p p i n g	shipping
r e s e r v e d	reserved
s u b j e c t	subject
b e t w e e n	between
f o r u m	forum
f a m i l y	family
l o n g	long
b a s e d	based
c o d e	code
s h o w	show
e v e n	even
b l a c k	black
c h e c k	check
s p e c i a l	special
p r i c e s	prices
w e b s i t e	website
i n d e x	index
b e i n g	being
w o m e n	women
m u c h	much
s i g n	sign
f i l e	file
l i n k	link
o p e n	open
t o d a y	today
t e c h n o l o g y	technology
s o u t h	south
c a s e	case
p r o j e c t	project
s a m e	same
p a g e s	pages
v e r s i o n	version
s e c t i o n	section
o w n	own
f o u n d	found
s p o r t s	sports
h o u s e	house
r e l a t e d	related
s e c u r i t y	security
b o t h	both
c o u n t y	county
a m e r i c a n	american
p h o t o	photo
g a m e	game
m e m b e r s	members
p o w e r	power
w h i l e	while
c a r e	care
n e t w o r k	network
d o w n	down
c o m p u t e r	computer
s y s t e m s	systems
t h r e e	three
t o t a l	total
p l a c e	place
e n d	end
f o l l o w i n g	following
d o w n l o a d	download
h i m	him
w i t h o u t	without
p e r	per
a c c e s s	access
t h i n k	think
n o r t h	north
r e s o u r c e s	resources
c u r r e n t	current
p o s t s	posts
b i g	big
m e d i a	media
l a w	law
c o n t r o l	control
w a t e r	water
h i s t o r y	history
p i c t u r e s	pictures
s i z e	size
a r t	art
p e r s o n a l	personal
s i n c e	since
i n c l u d i n g	including
g u i d e	guide
s h o p	shop
d i r e c t o r y	directory
b o a r d	board
l o c a t i o n	location
c h a n g e	change
w h i t e	white
t e x t	text
s m a l l	small
r a t i n g	rating
r a t e	rate
g o v e r n m e n t	government
c h i l d r e n	children
d u r i n g	during
u s a	usa
r e t u r n	return
s t u d e n t s	students
s h o p p i n g	shopping
a c c o u n t	account
t i m e s	times
s i t e s	sites
l e v e l	level
d i g i t a l	digital
p r o f i l e	profile
p r e v i o u s	previous
f o r m	form
e v e n t s	events
l o v e	love
o l d	old
j o h n	john
m a i n	main
c a l l	call
h o u r s	hours
i m a g e	image
d e p a r t m e n t	department
t i t l e	title
d e s c r i p t i o n	description
n o n	non
i n s u r a n c e	insurance
a n o t h e r	another
w h y	why
s h a l l	shall
p r o p e r t y	property
c l a s s	class
s t i l l	still
m o n e y	money
q u a l i t y	quality
e v e r y	every
l i s t i n g	listing
c o n t e n t	content
c o u n t r y	country
p r i v a t e	private
l i t t l e	little
v i s i t	visit
s a v e	save
t o o l s	tools
l o w	low
r e p l y	reply
c u s t o m e r	customer
d e c e m b e r	december
c o m p a r e	compare
m o v i e s	movies
i n c l u d e	include
c o l l e g e	college
v a l u e	value
a r t i c l e	article
y o r k	york
m a n	man
c a r d	card
j o b s	jobs
p r o v i d e	provide
f o o d	food
s o u r c e	source
a u t h o r	author
d i f f e r e n t	different
p r e s s	press
l e a r n	learn
s a l e	sale
a r o u n d	around
p r i n t	print
c o u r s e	course
j o b	job
c a n a d a	canada
p r o c e s s	process
t e e n	teen
r o o m	room
s t o c k	stock
t r a i n i n g	training
t o o	too
c r e d i t	credit
p o i n t	point
j o i n	join
s c i e n c e	science
m e n	men
c a t e g o r i e s	categories
a d v a n c e d	advanced
w e s t	west
s a l e s	sales
l o o k	look
e n g l i s h	english
l e f t	left
t e a m	team
e s t a t e	estate
b o x	box
c o n d i t i o n s	conditions
s e l e c t	select
w i n d o w s	windows
p h o t o s	photos
g a y	gay
t h r e a d	thread
w e e k	week
c a t e g o r y	category
n o t e	note
l i v e	live
l a r g e	large
g a l l e r y	gallery
t a b l e	table
r e g i s t e r	register
h o w e v e r	however
j u n e	june
o c t o b e r	october
n o v e m b e r	november
m a r k e t	market
l i b r a r y	library
r e a l l y	really
a c t i o n	action
s t a r t	start
s e r i e s	series
m o d e l	model
f e a t u r e s	features
a i r	air
i n d u s t r y	industry
p l a n	plan
h u m a n	human
p r o v i d e d	provided
y e s	yes
r e q u i r e d	required
s e c o n d	second
h o t	hot
a c c e s s o r i e s	accessories
c o s t	cost
m o v i e	movie
f o r u m s	forums
m a r c h	march
s e p t e m b e r	september
b e t t e r	better
s a y	say
q u e s t i o n s	questions
j u l y	july
y a h o o	yahoo
g o i n g	going
m e d i c a l	medical
t e s t	test
f r i e n d	friend
c o m e	come
d e c	dec
s e r v e r	server
s t u d y	study
a p p l i c a t i o n	application
c a r t	cart
s t a f f	staff
a r t i c l e s	articles
s a n	san
f e e d b a c k	feedback
a g a i n	again
p l a y	play
l o o k i n g	looking
i s s u e s	issues
a p r i l	april
n e v e r	never
u s e r s	users
c o m p l e t e	complete
s t r e e t	street
t o p i c	topic
c o m m e n t	comment
f i n a n c i a l	financial
t h i n g s	things
w o r k i n g	working
a g a i n s t	against
s t a n d a r d	standard
t a x	tax
p e r s o n	person
b e l o w	below
m o b i l e	mobile
l e s s	less
g o t	got
b l o g	blog
p a r t y	party
p a y m e n t	payment
e q u i p m e n t	equipment
l o g i n	login
s t u d e n t	student
l e t	let
p r o g r a m s	programs
o f f e r s	offers
l e g a l	legal
a b o v e	above
r e c e n t	recent
p a r k	park
s t o r e s	stores
s i d e	side
a c t	act
p r o b l e m	problem
r e d	red
g i v e	give
m e m o r y	memory
p e r f o r m a n c e	performance
s o c i a l	social
a u g u s t	august
q u o t e	quote
l a n g u a g e	language
s t o r y	story
s e l l	sell
o p t i o n s	options
e x p e r i e n c e	experience
r a t e s	rates
c r e a t e	create
k e y	key
b o d y	body
y o u n g	young
a m e r i c a	america
i m p o r t a n t	important
f i e l d	field
f e w	few
e a s t	east
p a p e r	paper
s i n g l e	single
a g e	age
a c t i v i t i e s	activities
c l u b	club
e x a m p l e	example
g i r l s	girls
a d d i t i o n a l	additional
p a s s w o r d	password
l a t e s t	latest
s o m e t h i n g	something
r o a d	road
g i f t	gift
q u e s t i o n	question
c h a n g e s	changes
n i g h t	night
h a r d	hard
t e x a s	texas
o c t	oct
p a y	pay
f o u r	four
p o k e r	poker
s t a t u s	status
b r o w s e	browse
i s s u e	issue
r a n g e	range
b u i l d i n g	building
s e l l e r	seller
c o u r t	court
f e b r u a r y	february
a l w a y s	always
r e s u l t	result
a u d i o	audio
l i g h t	light
w r i t e	write
w a r	war
n o v	nov
o f f e r	offer
b l u e	blue
g r o u p s	groups
e a s y	easy
g i v e n	given
f i l e s	files
e v e n t	event
r e l e a s e	release
a n a l y s i s	analysis
r e q u e s t	request
f a x	fax
c h i n a	china
m a k i n g	making
p i c t u r e	picture
n e e d s	needs
p o s s i b l e	possible
m i g h t	might
p r o f e s s i o n a l	professional
y e t	yet
m o n t h	month
m a j o r	major
s t a r	star
a r e a s	areas
f u t u r e	future
s p a c e	space
c o m m i t t e e	committee
h a n d	hand
s u n	sun
c a r d s	cards
p r o b l e m s	problems
l o n d o n	london
w a s h i n g t o n	washington
m e e t i n g	meeting
r s s	rss
b e c o m e	become
i n t e r e s t	interest
c h i l d	child
k e e p	keep
e n t e r	enter
c a l i f o r n i a	california
p o r n	porn
s h a r e	share
s i m i l a r	similar
g a r d e n	garden
s c h o o l s	schools
m i l l i o n	million
a d d e d	added
r e f e r e n c e	reference
c o m p a n i e s	companies
l i s t e d	listed
b a b y	baby
l e a r n i n g	learning
e n e r g y	energy
r u n	run
d e l i v e r y	delivery
n e t	net
p o p u l a r	popular
t e r m	term
f i l m	film
s t o r i e s	stories
p u t	put
c o m p u t e r s	computers
j o u r n a l	journal
r e p o r t s	reports
t r y	try
w e l c o m e	welcome
c e n t r a l	central
i m a g e s	images
p r e s i d e n t	president
n o t i c e	notice
g o d	god
o r i g i n a l	original
h e a d	head
r a d i o	radio
u n t i l	until
c e l l	cell
c o l o r	color
s e l f	self
c o u n c i l	council
a w a y	away
i n c l u d e s	includes
t r a c k	track
a u s t r a l i a	australia
d i s c u s s i o n	discussion
a r c h i v e	archive
o n c e	once
o t h e r s	others
e n t e r t a i n m e n t	entertainment
a g r e e m e n t	agreement
f o r m a t	format
l e a s t	least
s o c i e t y	society
m o n t h s	months
l o g	log
s a f e t y	safety
f r i e n d s	friends
s u r e	sure
f a q	faq
t r a d e	trade
e d i t i o n	edition
c a r s	cars
m e s s a g e s	messages
m a r k e t i n g	marketing
t e l l	tell
f u r t h e r	further
u p d a t e d	updated
a s s o c i a t i o n	association
a b l e	able
h a v i n g	having
p r o v i d e s	provides
d a v i d	david
f u n	fun
a l r e a d y	already
g r e e n	green
s t u d i e s	studies
c l o s e	close
c o m m o n	common
d r i v e	drive
s p e c i f i c	specific
s e v e r a l	several
g o l d	gold
f e b	feb
l i v i n g	living
s e p	sep
c o l l e c t i o n	collection
c a l l e d	called
s h o r t	short
a r t s	arts
l o t	lot
a s k	ask
d i s p l a y	display
l i m i t e d	limited
p o w e r e d	powered
s o l u t i o n s	solutions
m e a n s	means
d i r e c t o r	director
d a i l y	daily
b e a c h	beach
p a s t	past
n a t u r a l	natural
w h e t h e r	whether
d u e	due
e l e c t r o n i c s	electronics
f i v e	five
u p o n	upon
p e r i o d	period
p l a n n i n g	planning
d a t a b a s e	database
s a y s	says
o f f i c i a l	official
w e a t h e r	weather
m a r	mar
l a n d	land
a v e r a g e	average
d o n e	done
t e c h n i c a l	technical
w i n d o w	window
f r a n c e	france
p r o	pro
r e g i o n	region
i s l a n d	island
r e c o r d	record
d i r e c t	direct
m i c r o s o f t	microsoft
c o n f e r e n c e	conference
e n v i r o n m e n t	environment
r e c o r d s	records
d i s t r i c t	district
c a l e n d a r	calendar
c o s t s	costs
s t y l e	style
u r l	url
f r o n t	front
s t a t e m e n t	statement
u p d a t e	update
p a r t s	parts
a u g	aug
e v e r	ever
d o w n l o a d s	downloads
e a r l y	early
m i l e s	miles
s o u n d	sound
r e s o u r c e	resource
p r e s e n t	present
a p p l i c a t i o n s	applications
e i t h e r	either
a g o	ago
d o c u m e n t	document
w o r d	word
w o r k s	works
m a t e r i a l	material
b i l l	bill
a p r	apr
w r i t t e n	written
t a l k	talk
f e d e r a l	federal
h o s t i n g	hosting
r u l e s	rules
f i n a l	final
a d u l t	adult
t i c k e t s	tickets
t h i n g	thing
c e n t r e	centre
r e q u i r e m e n t s	requirements
v i a	via
c h e a p	cheap
n u d e	nude
k i d s	kids
f i n a n c e	finance
t r u e	true
m i n u t e s	minutes
e l s e	else
m a r k	mark
t h i r d	third
r o c k	rock
g i f t s	gifts
e u r o p e	europe
r e a d i n g	reading
t o p i c s	topics
b a d	bad
i n d i v i d u a l	individual
t i p s	tips
p l u s	plus
a u t o	auto
c o v e r	cover
u s u a l l y	usually
e d i t	edit
t o g e t h e r	together
v i d e o s	videos
p e r c e n t	percent
f a s t	fast
f u n c t i o n	function
f a c t	fact
u n i t	unit
g e t t i n g	getting
g l o b a l	global
t e c h	tech
m e e t	meet
f a r	far
e c o n o m i c	economic
p l a y e r	player
p r o j e c t s	projects
l y r i c s	lyrics
o f t e n	often
s u b s c r i b e	subscribe
s u b m i t	submit
g e r m a n y	germany
a m o u n t	amount
w a t c h	watch
i n c l u d e d	included
f e e l	feel
t h o u g h	though
b a n k	bank
r i s k	risk
t h a n k s	thanks
e v e r y t h i n g	everything
d e a l s	deals
v a r i o u s	various
w o r d s	words
l i n u x	linux
j u l	jul
p r o d u c t i o n	production
c o m m e r c i a l	commercial
j a m e s	james
w e i g h t	weight
t o w n	town
h e a r t	heart
a d v e r t i s i n g	advertising
r e c e i v e d	received
c h o o s e	choose
t r e a t m e n t	treatment
n e w s l e t t e r	newsletter
a r c h i v e s	archives
p o i n t s	points
k n o w l e d g e	knowledge
m a g a z i n e	magazine
e r r o r	error
c a m e r a	camera
j u n	jun
g i r l	girl
c u r r e n t l y	currently
c o n s t r u c t i o n	construction
t o y s	toys
r e g i s t e r e d	registered
c l e a r	clear
g o l f	golf
r e c e i v e	receive
d o m a i n	domain
m e t h o d s	methods
c h a p t e r	chapter
m a k e s	makes
p r o t e c t i o n	protection
p o l i c i e s	policies
l o a n	loan
w i d e	wide
b e a u t y	beauty
m a n a g e r	manager
i n d i a	india
p o s i t i o n	position
t a k e n	taken
s o r t	sort
l i s t i n g s	listings
m o d e l s	models
m i c h a e l	michael
k n o w n	known
h a l f	half
c a s e s	cases
s t e p	step
e n g i n e e r i n g	engineering
f l o r i d a	florida
s i m p l e	simple
q u i c k	quick
n o n e	none
w i r e l e s s	wireless
l i c e n s e	license
p a u l	paul
f r i d a y	friday
l a k e	lake
w h o l e	whole
a n n u a l	annual
p u b l i s h e d	published
l a t e r	later
b a s i c	basic
s o n y	sony
s h o w s	shows
c o r p o r a t e	corporate
g o o g l e	google
c h u r c h	church
m e t h o d	method
p u r c h a s e	purchase
c u s t o m e r s	customers
a c t i v e	active
r e s p o n s e	response
p r a c t i c e	practice
h a r d w a r e	hardware
f i g u r e	figure
m a t e r i a l s	materials
f i r e	fire
h o l i d a y	holiday
c h a t	chat
e n o u g h	enough
d e s i g n e d	designed
a l o n g	along
a m o n g	among
d e a t h	death
w r i t i n g	writing
s p e e d	speed
h t m l	html
c o u n t r i e s	countries
l o s s	loss
f a c e	face
b r a n d	brand
d i s c o u n t	discount
h i g h e r	higher
e f f e c t s	effects
c r e a t e d	created
r e m e m b e r	remember
s t a n d a r d s	standards
o i l	oil
b i t	bit
y e l l o w	yellow
p o l i t i c a l	political
i n c r e a s e	increase
a d v e r t i s e	advertise
k i n g d o m	kingdom
b a s e	base
n e a r	near
e n v i r o n m e n t a l	environmental
t h o u g h t	thought
s t u f f	stuff
f r e n c h	french
s t o r a g e	storage
j a p a n	japan
d o i n g	doing
l o a n s	loans
s h o e s	shoes
e n t r y	entry
s t a y	stay
n a t u r e	nature
o r d e r s	orders
a v a i l a b i l i t y	availability
a f r i c a	africa
s u m m a r y	summary
t u r n	turn
m e a n	mean
g r o w t h	growth
n o t e s	notes
a g e n c y	agency
k i n g	king
m o n d a y	monday
e u r o p e a n	european
a c t i v i t y	activity
c o p y	copy
a l t h o u g h	although
d r u g	drug
p i c s	pics
w e s t e r n	western
i n c o m e	income
f o r c e	force
c a s h	cash
e m p l o y m e n t	employment
o v e r a l l	overall
b a y	bay
r i v e r	river
c o m m i s s i o n	commission
p a c k a g e	package
c o n t e n t s	contents
s e e n	seen
p l a y e r s	players
e n g i n e	engine
p o r t	port
a l b u m	album
r e g i o n a l	regional
s t o p	stop
s u p p l i e s	supplies
s t a r t e d	started
a d m i n i s t r a t i o n	administration
b a r	bar
i n s t i t u t e	institute
v i e w s	views
p l a n s	plans
d o u b l e	double
d o g	dog
b u i l d	build
s c r e e n	screen
e x c h a n g e	exchange
t y p e s	types
s o o n	soon
s p o n s o r e d	sponsored
l i n e s	lines
e l e c t r o n i c	electronic
c o n t i n u e	continue
a c r o s s	across
b e n e f i t s	benefits
n e e d e d	needed
s e a s o n	season
a p p l y	apply
s o m e o n e	someone
h e l d	held
a n y t h i n g	anything
p r i n t e r	printer
c o n d i t i o n	condition
e f f e c t i v e	effective
b e l i e v e	believe
