input1	label
the	t h e
and	a n d
for	f o r
that	t h a t
this	t h i s
with	w i t h
you	y o u
not	n o t
are	a r e
from	f r o m
your	y o u r
all	a l l
have	h a v e
new	n e w
more	m o r e
was	w a s
will	w i l l
home	h o m e
can	c a n
about	a b o u t
page	p a g e
has	h a s
search	s e a r c h
free	f r e e
but	b u t
our	o u r
one	o n e
other	o t h e r
information	i n f o r m a t i o n
time	t i m e
they	t h e y
site	s i t e
may	m a y
what	w h a t
which	w h i c h
their	t h e i r
news	n e w s
out	o u t
use	u s e
any	a n y
there	t h e r e
see	s e e
only	o n l y
his	h i s
when	w h e n
contact	c o n t a c t
here	h e r e
business	b u s i n e s s
who	w h o
web	w e b
also	a l s o
now	n o w
help	h e l p
get	g e t
view	v i e w
online	o n l i n e
first	f i r s t
been	b e e n
would	w o u l d
how	h o w
were	w e r e
services	s e r v i c e s
some	s o m e
these	t h e s e
click	c l i c k
its	i t s
like	l i k e
service	s e r v i c e
than	t h a n
find	f i n d
price	p r i c e
date	d a t e
back	b a c k
top	t o p
people	p e o p l e
had	h a d
list	l i s t
name	n a m e
just	j u s t
over	o v e r
state	s t a t e
year	y e a r
day	d a y
into	i n t o
email	e m a i l
two	t w o
health	h e a l t h
world	w o r l d
next	n e x t
used	u s e d
work	w o r k
last	l a s t
most	m o s t
products	p r o d u c t s
music	m u s i c
buy	b u y
data	d a t a
make	m a k e
them	t h e m
should	s h o u l d
product	p r o d u c t
system	s y s t e m
post	p o s t
her	h e r
city	c i t y
add	a d d
policy	p o l i c y
number	n u m b e r
such	s u c h
please	p l e a s e
available	a v a i l a b l e
copyright	c o p y r i g h t
support	s u p p o r t
message	m e s s a g e
after	a f t e r
best	b e s t
software	s o f t w a r e
then	t h e n
jan	j a n
good	g o o d
video	v i d e o
well	w e l l
where	w h e r e
info	i n f o
rights	r i g h t s
public	p u b l i c
books	b o o k s
high	h i g h
school	s c h o o l
through	t h r o u g h
each	e a c h
links	l i n k s
she	s h e
review	r e v i e w
years	y e a r s
order	o r d e r
very	v e r y
privacy	p r i v a c y
book	b o o k
items	i t e m s
company	c o m p a n y
read	r e a d
group	g r o u p
sex	s e x
need	n e e d
many	m a n y
user	u s e r
said	s a i d
does	d o e s
set	s e t
under	u n d e r
general	g e n e r a l
research	r e s e a r c h
university	u n i v e r s i t y
january	j a n u a r y
mail	m a i l
full	f u l l
map	m a p
reviews	r e v i e w s
program	p r o g r a m
life	l i f e
know	k n o w
games	g a m e s
way	w a y
days	d a y s
management	m a n a g e m e n t
part	p a r t
could	c o u l d
great	g r e a t
united	u n i t e d
hotel	h o t e l
real	r e a l
item	i t e m
international	i n t e r n a t i o n a l
center	c e n t e r
ebay	e b a y
must	m u s t
store	s t o r e
travel	t r a v e l
comments	c o m m e n t s
made	m a d e
development	d e v e l o p m e n t
report	r e p o r t
off	o f f
member	m e m b e r
details	d e t a i l s
line	l i n e
terms	t e r m s
before	b e f o r e
hotels	h o t e l s
did	d i d
send	s e n d
right	r i g h t
type	t y p e
because	b e c a u s e
local	l o c a l
those	t h o s e
using	u s i n g
results	r e s u l t s
office	o f f i c e
education	e d u c a t i o n
national	n a t i o n a l
car	c a r
design	d e s i g n
take	t a k e
posted	p o s t e d
internet	i n t e r n e t
address	a d d r e s s
community	c o m m u n i t y
within	w i t h i n
states	s t a t e s
area	a r e a
want	w a n t
phone	p h o n e
dvd	d v d
shipping	s h i p p i n g
reserved	r e s e r v e d
subject	s u b j e c t
between	b e t w e e n
forum	f o r u m
family	f a m i l y
long	l o n g
based	b a s e d
code	c o d e
show	s h o w
even	e v e n
black	b l a c k
check	c h e c k
special	s p e c i a l
prices	p r i c e s
website	w e b s i t e
index	i n d e x
being	b e i n g
women	w o m e n
much	m u c h
sign	s i g n
file	f i l e
link	l i n k
open	o p e n
today	t o d a y
technology	t e c h n o l o g y
south	s o u t h
case	c a s e
project	p r o j e c t
same	s a m e
pages	p a g e s
version	v e r s i o n
section	s e c t i o n
own	o w n
found	f o u n d
sports	s p o r t s
house	h o u s e
related	r e l a t e d
security	s e c u r i t y
both	b o t h
county	c o u n t y
american	a m e r i c a n
photo	p h o t o
game	g a m e
members	m e m b e r s
power	p o w e r
while	w h i l e
care	c a r e
network	n e t w o r k
down	d o w n
computer	c o m p u t e r
systems	s y s t e m s
three	t h r e e
total	t o t a l
place	p l a c e
end	e n d
following	f o l l o w i n g
download	d o w n l o a d
him	h i m
without	w i t h o u t
per	p e r
access	a c c e s s
think	t h i n k
north	n o r t h
resources	r e s o u r c e s
current	c u r r e n t
posts	p o s t s
big	b i g
media	m e d i a
law	l a w
control	c o n t r o l
water	w a t e r
history	h i s t o r y
pictures	p i c t u r e s
size	s i z e
art	a r t
personal	p e r s o n a l
since	s i n c e
including	i n c l u d i n g
guide	g u i d e
shop	s h o p
directory	d i r e c t o r y
board	b o a r d
location	l o c a t i o n
change	c h a n g e
white	w h i t e
text	t e x t
small	s m a l l
rating	r a t i n g
rate	r a t e
government	g o v e r n m e n t
children	c h i l d r e n
during	d u r i n g
usa	u s a
return	r e t u r n
students	s t u d e n t s
shopping	s h o p p i n g
account	a c c o u n t
times	t i m e s
sites	s i t e s
level	l e v e l
digital	d i g i t a l
profile	p r o f i l e
previous	p r e v i o u s
form	f o r m
events	e v e n t s
love	l o v e
old	o l d
john	j o h n
main	m a i n
call	c a l l
hours	h o u r s
image	i m a g e
department	d e p a r t m e n t
title	t i t l e
description	d e s c r i p t i o n
non	n o n
insurance	i n s u r a n c e
another	a n o t h e r
why	w h y
shall	s h a l l
property	p r o p e r t y
class	c l a s s
still	s t i l l
money	m o n e y
quality	q u a l i t y
every	e v e r y
listing	l i s t i n g
content	c o n t e n t
country	c o u n t r y
private	p r i v a t e
little	l i t t l e
visit	v i s i t
save	s a v e
tools	t o o l s
low	l o w
reply	r e p l y
customer	c u s t o m e r
december	d e c e m b e r
compare	c o m p a r e
movies	m o v i e s
include	i n c l u d e
college	c o l l e g e
value	v a l u e
article	a r t i c l e
york	y o r k
man	m a n
card	c a r d
jobs	j o b s
provide	p r o v i d e
food	f o o d
source	s o u r c e
author	a u t h o r
different	d i f f e r e n t
press	p r e s s
learn	l e a r n
sale	s a l e
around	a r o u n d
print	p r i n t
course	c o u r s e
job	j o b
canada	c a n a d a
process	p r o c e s s
teen	t e e n
room	r o o m
stock	s t o c k
training	t r a i n i n g
too	t o o
credit	c r e d i t
point	p o i n t
join	j o i n
science	s c i e n c e
men	m e n
categories	c a t e g o r i e s
advanced	a d v a n c e d
west	w e s t
sales	s a l e s
look	l o o k
english	e n g l i s h
left	l e f t
team	t e a m
estate	e s t a t e
box	b o x
conditions	c o n d i t i o n s
select	s e l e c t
windows	w i n d o w s
photos	p h o t o s
gay	g a y
thread	t h r e a d
week	w e e k
category	c a t e g o r y
note	n o t e
live	l i v e
large	l a r g e
gallery	g a l l e r y
table	t a b l e
register	r e g i s t e r
however	h o w e v e r
june	j u n e
october	o c t o b e r
november	n o v e m b e r
market	m a r k e t
library	l i b r a r y
really	r e a l l y
action	a c t i o n
start	s t a r t
series	s e r i e s
model	m o d e l
features	f e a t u r e s
air	a i r
industry	i n d u s t r y
plan	p l a n
human	h u m a n
provided	p r o v i d e d
yes	y e s
required	r e q u i r e d
second	s e c o n d
hot	h o t
accessories	a c c e s s o r i e s
cost	c o s t
movie	m o v i e
forums	f o r u m s
march	m a r c h
september	s e p t e m b e r
better	b e t t e r
say	s a y
questions	q u e s t i o n s
july	j u l y
yahoo	y a h o o
going	g o i n g
medical	m e d i c a l
test	t e s t
friend	f r i e n d
come	c o m e
dec	d e c
server	s e r v e r
study	s t u d y
application	a p p l i c a t i o n
cart	c a r t
staff	s t a f f
articles	a r t i c l e s
san	s a n
feedback	f e e d b a c k
again	a g a i n
play	p l a y
looking	l o o k i n g
issues	i s s u e s
april	a p r i l
never	n e v e r
users	u s e r s
complete	c o m p l e t e
street	s t r e e t
topic	t o p i c
comment	c o m m e n t
financial	f i n a n c i a l
things	t h i n g s
working	w o r k i n g
against	a g a i n s t
standard	s t a n d a r d
tax	t a x
person	p e r s o n
below	b e l o w
mobile	m o b i l e
less	l e s s
got	g o t
blog	b l o g
party	p a r t y
payment	p a y m e n t
equipment	e q u i p m e n t
login	l o g i n
student	s t u d e n t
let	l e t
programs	p r o g r a m s
offers	o f f e r s
legal	l e g a l
above	a b o v e
recent	r e c e n t
park	p a r k
stores	s t o r e s
side	s i d e
act	a c t
problem	p r o b l e m
red	r e d
give	g i v e
memory	m e m o r y
performance	p e r f o r m a n c e
social	s o c i a l
august	a u g u s t
quote	q u o t e
language	l a n g u a g e
story	s t o r y
sell	s e l l
options	o p t i o n s
experience	e x p e r i e n c e
rates	r a t e s
create	c r e a t e
key	k e y
body	b o d y
young	y o u n g
america	a m e r i c a
important	i m p o r t a n t
field	f i e l d
few	f e w
east	e a s t
paper	p a p e r
single	s i n g l e
age	a g e
activities	a c t i v i t i e s
club	c l u b
example	e x a m p l e
girls	g i r l s
additional	a d d i t i o n a l
password	p a s s w o r d
latest	l a t e s t
something	s o m e t h i n g
road	r o a d
gift	g i f t
question	q u e s t i o n
changes	c h a n g e s
night	n i g h t
hard	h a r d
texas	t e x a s
oct	o c t
pay	p a y
four	f o u r
poker	p o k e r
status	s t a t u s
browse	b r o w s e
issue	i s s u e
range	r a n g e
building	b u i l d i n g
seller	s e l l e r
court	c o u r t
february	f e b r u a r y
always	a l w a y s
result	r e s u l t
audio	a u d i o
light	l i g h t
write	w r i t e
war	w a r
nov	n o v
offer	o f f e r
blue	b l u e
groups	g r o u p s
easy	e a s y
given	g i v e n
files	f i l e s
event	e v e n t
release	r e l e a s e
analysis	a n a l y s i s
request	r e q u e s t
fax	f a x
china	c h i n a
making	m a k i n g
picture	p i c t u r e
needs	n e e d s
possible	p o s s i b l e
might	m i g h t
professional	p r o f e s s i o n a l
yet	y e t
month	m o n t h
major	m a j o r
star	s t a r
areas	a r e a s
future	f u t u r e
space	s p a c e
committee	c o m m i t t e e
hand	h a n d
sun	s u n
cards	c a r d s
problems	p r o b l e m s
london	l o n d o n
washington	w a s h i n g t o n
meeting	m e e t i n g
rss	r s s
become	b e c o m e
interest	i n t e r e s t
child	c h i l d
keep	k e e p
enter	e n t e r
california	c a l i f o r n i a
porn	p o r n
share	s h a r e
similar	s i m i l a r
garden	g a r d e n
schools	s c h o o l s
million	m i l l i o n
added	a d d e d
reference	r e f e r e n c e
companies	c o m p a n i e s
listed	l i s t e d
baby	b a b y
learning	l e a r n i n g
energy	e n e r g y
run	r u n
delivery	d e l i v e r y
net	n e t
popular	p o p u l a r
term	t e r m
film	f i l m
stories	s t o r i e s
put	p u t
computers	c o m p u t e r s
journal	j o u r n a l
reports	r e p o r t s
try	t r y
welcome	w e l c o m e
central	c e n t r a l
images	i m a g e s
president	p r e s i d e n t
notice	n o t i c e
god	g o d
original	o r i g i n a l
head	h e a d
radio	r a d i o
until	u n t i l
cell	c e l l
color	c o l o r
self	s e l f
council	c o u n c i l
away	a w a y
includes	i n c l u d e s
track	t r a c k
australia	a u s t r a l i a
discussion	d i s c u s s i o n
archive	a r c h i v e
once	o n c e
others	o t h e r s
entertainment	e n t e r t a i n m e n t
agreement	a g r e e m e n t
format	f o r m a t
least	l e a s t
society	s o c i e t y
months	m o n t h s
log	l o g
safety	s a f e t y
friends	f r i e n d s
sure	s u r e
faq	f a q
trade	t r a d e
edition	e d i t i o n
cars	c a r s
messages	m e s s a g e s
marketing	m a r k e t i n g
tell	t e l l
further	f u r t h e r
updated	u p d a t e d
association	a s s o c i a t i o n
able	a b l e
having	h a v i n g
provides	p r o v i d e s
david	d a v i d
fun	f u n
already	a l r e a d y
green	g r e e n
studies	s t u d i e s
close	c l o s e
common	c o m m o n
drive	d r i v e
specific	s p e c i f i c
several	s e v e r a l
gold	g o l d
feb	f e b
living	l i v i n g
sep	s e p
collection	c o l l e c t i o n
called	c a l l e d
short	s h o r t
arts	a r t s
lot	l o t
ask	a s k
display	d i s p l a y
limited	l i m i t e d
powered	p o w e r e d
solutions	s o l u t i o n s
means	m e a n s
director	d i r e c t o r
daily	d a i l y
beach	b e a c h
past	p a s t
natural	n a t u r a l
whether	w h e t h e r
due	d u e
electronics	e l e c t r o n i c s
five	f i v e
upon	u p o n
period	p e r i o d
planning	p l a n n i n g
database	d a t a b a s e
says	s a y s
official	o f f i c i a l
weather	w e a t h e r
mar	m a r
land	l a n d
average	a v e r a g e
done	d o n e
technical	t e c h n i c a l
window	w i n d o w
france	f r a n c e
pro	p r o
region	r e g i o n
island	i s l a n d
record	r e c o r d
direct	d i r e c t
microsoft	m i c r o s o f t
conference	c o n f e r e n c e
environment	e n v i r o n m e n t
records	r e c o r d s
district	d i s t r i c t
calendar	c a l e n d a r
costs	c o s t s
style	s t y l e
url	u r l
front	f r o n t
statement	s t a t e m e n t
update	u p d a t e
parts	p a r t s
aug	a u g
ever	e v e r
downloads	d o w n l o a d s
early	e a r l y
miles	m i l e s
sound	s o u n d
resource	r e s o u r c e
present	p r e s e n t
applications	a p p l i c a t i o n s
either	e i t h e r
ago	a g o
document	d o c u m e n t
word	w o r d
works	w o r k s
material	m a t e r i a l
bill	b i l l
apr	a p r
written	w r i t t e n
talk	t a l k
federal	f e d e r a l
hosting	h o s t i n g
rules	r u l e s
final	f i n a l
adult	a d u l t
tickets	t i c k e t s
thing	t h i n g
centre	c e n t r e
requirements	r e q u i r e m e n t s
via	v i a
cheap	c h e a p
nude	n u d e
kids	k i d s
finance	f i n a n c e
true	t r u e
minutes	m i n u t e s
else	e l s e
mark	m a r k
third	t h i r d
rock	r o c k
gifts	g i f t s
europe	e u r o p e
reading	r e a d i n g
topics	t o p i c s
bad	b a d
individual	i n d i v i d u a l
tips	t i p s
plus	p l u s
auto	a u t o
cover	c o v e r
usually	u s u a l l y
edit	e d i t
together	t o g e t h e r
videos	v i d e o s
percent	p e r c e n t
fast	f a s t
function	f u n c t i o n
fact	f a c t
unit	u n i t
getting	g e t t i n g
global	g l o b a l
tech	t e c h
meet	m e e t
far	f a r
economic	e c o n o m i c
player	p l a y e r
projects	p r o j e c t s
lyrics	l y r i c s
often	o f t e n
subscribe	s u b s c r i b e
submit	s u b m i t
germany	g e r m a n y
amount	a m o u n t
watch	w a t c h
included	i n c l u d e d
feel	f e e l
though	t h o u g h
bank	b a n k
risk	r i s k
thanks	t h a n k s
everything	e v e r y t h i n g
deals	d e a l s
various	v a r i o u s
words	w o r d s
linux	l i n u x
jul	j u l
production	p r o d u c t i o n
commercial	c o m m e r c i a l
james	j a m e s
weight	w e i g h t
town	t o w n
heart	h e a r t
advertising	a d v e r t i s i n g
received	r e c e i v e d
choose	c h o o s e
treatment	t r e a t m e n t
newsletter	n e w s l e t t e r
archives	a r c h i v e s
points	p o i n t s
knowledge	k n o w l e d g e
magazine	m a g a z i n e
error	e r r o r
camera	c a m e r a
jun	j u n
girl	g i r l
currently	c u r r e n t l y
construction	c o n s t r u c t i o n
toys	t o y s
registered	r e g i s t e r e d
clear	c l e a r
golf	g o l f
receive	r e c e i v e
domain	d o m a i n
methods	m e t h o d s
chapter	c h a p t e r
makes	m a k e s
protection	p r o t e c t i o n
policies	p o l i c i e s
loan	l o a n
wide	w i d e
beauty	b e a u t y
manager	m a n a g e r
india	i n d i a
position	p o s i t i o n
taken	t a k e n
sort	s o r t
listings	l i s t i n g s
models	m o d e l s
michael	m i c h a e l
known	k n o w n
half	h a l f
cases	c a s e s
step	s t e p
engineering	e n g i n e e r i n g
florida	f l o r i d a
simple	s i m p l e
quick	q u i c k
none	n o n e
wireless	w i r e l e s s
license	l i c e n s e
paul	p a u l
friday	f r i d a y
lake	l a k e
whole	w h o l e
annual	a n n u a l
published	p u b l i s h e d
later	l a t e r
basic	b a s i c
sony	s o n y
shows	s h o w s
corporate	c o r p o r a t e
google	g o o g l e
church	c h u r c h
method	m e t h o d
purchase	p u r c h a s e
customers	c u s t o m e r s
active	a c t i v e
response	r e s p o n s e
practice	p r a c t i c e
hardware	h a r d w a r e
figure	f i g u r e
materials	m a t e r i a l s
fire	f i r e
holiday	h o l i d a y
chat	c h a t
enough	e n o u g h
designed	d e s i g n e d
along	a l o n g
among	a m o n g
death	d e a t h
writing	w r i t i n g
speed	s p e e d
html	h t m l
countries	c o u n t r i e s
loss	l o s s
face	f a c e
brand	b r a n d
discount	d i s c o u n t
higher	h i g h e r
effects	e f f e c t s
created	c r e a t e d
remember	r e m e m b e r
standards	s t a n d a r d s
oil	o i l
bit	b i t
yellow	y e l l o w
political	p o l i t i c a l
increase	i n c r e a s e
advertise	a d v e r t i s e
kingdom	k i n g d o m
base	b a s e
near	n e a r
environmental	e n v i r o n m e n t a l
thought	t h o u g h t
stuff	s t u f f
french	f r e n c h
storage	s t o r a g e
japan	j a p a n
doing	d o i n g
loans	l o a n s
shoes	s h o e s
entry	e n t r y
stay	s t a y
nature	n a t u r e
orders	o r d e r s
availability	a v a i l a b i l i t y
africa	a f r i c a
summary	s u m m a r y
turn	t u r n
mean	m e a n
growth	g r o w t h
notes	n o t e s
agency	a g e n c y
king	k i n g
monday	m o n d a y
european	e u r o p e a n
activity	a c t i v i t y
copy	c o p y
although	a l t h o u g h
drug	d r u g
pics	p i c s
western	w e s t e r n
income	i n c o m e
force	f o r c e
cash	c a s h
employment	e m p l o y m e n t
overall	o v e r a l l
bay	b a y
river	r i v e r
commission	c o m m i s s i o n
package	p a c k a g e
contents	c o n t e n t s
seen	s e e n
players	p l a y e r s
engine	e n g i n e
port	p o r t
album	a l b u m
regional	r e g i o n a l
stop	s t o p
supplies	s u p p l i e s
started	s t a r t e d
administration	a d m i n i s t r a t i o n
bar	b a r
institute	i n s t i t u t e
views	v i e w s
plans	p l a n s
double	d o u b l e
dog	d o g
build	b u i l d
screen	s c r e e n
exchange	e x c h a n g e
types	t y p e s
soon	s o o n
sponsored	s p o n s o r e d
lines	l i n e s
electronic	e l e c t r o n i c
continue	c o n t i n u e
across	a c r o s s
benefits	b e n e f i t s
needed	n e e d e d
season	s e a s o n
apply	a p p l y
someone	s o m e o n e
held	h e l d
anything	a n y t h i n g
printer	p r i n t e r
condition	c o n d i t i o n
effective	e f f e c t i v e
believe	b e l i e v e
